this	DT	this
is	VBZ	be
n't	RB	n't
comedic	JJ	comedic
robin	NN	robin
williams	NNS	<unknown>
nor	CC	nor
quirky	JJ	quirky
insane	JJ	insane
robin	NN	robin
williams	NP	Williams
recent	JJ	recent
thriller	NN	thriller
fame	NN	fame
hybrid	JJ	hybrid
classic	JJ	classic
drama	NN	drama
dramatization	NN	dramatization
mixed	JJ	mixed
robin	NN	robin
's	POS	's
new	JJ	new
love	NN	love
thriller	NN	thriller
but	CC	but
is	VBZ	be
n't	RB	n't
thriller	NN	thriller
se	FW	se
more	JJR	more
mystery	NN	mystery
suspense	NN	suspense
vehicle	NN	vehicle
williams	NP	Williams
attempts	NNS	attempt
locate	VBP	locate
sick	JJ	sick
boy	NN	boy
keeper	NN	keeper
starring	VBG	star
sandra	VBG	<unknown>
oh	UH	oh
rory	JJ	<unknown>
culkin	NN	<unknown>
suspense	NN	suspense
drama	NN	drama
plays	VBZ	play
pretty	RB	pretty
much	RB	much
like	IN	like
news	NN	news
report	NN	report
william	NP	William
's	POS	's
character	NN	character
gets	VBZ	get
close	JJ	close
achieving	VBG	achieve
goal	NN	goal
say	VBP	say
highly	RB	highly
entertained	VBN	entertain
though	IN	though
fails	NNS	fail
teach	VBP	teach
guide	NN	guide
inspect	VBP	inspect
amuse	VB	amuse
felt	VBD	feel
more	RBR	more
like	IN	like
watching	VBG	watch
guy	NN	guy
williams	NNS	<unknown>
as	IN	as
actually	RB	actually
performing	VBG	perform
actions	NNS	action
person	NN	person
perspective	NN	perspective
words	NNS	word
felt	VBD	feel
real	RB	real
able	JJ	able
subscribe	VBP	subscribe
premise	NN	premise
story	NN	story
all	PDT	all
all	DT	all
it	PP	it
's	VBZ	be
worth	JJ	worth
watch	NN	watch
though	IN	though
it	PP	it
's	VBZ	be
definitely	RB	definitely
not	RB	not
friday	JJ	<unknown>
saturday	NN	Saturday
night	NN	night
fare	VBP	fare
rates	NNS	rate
7	CD	7
7	CD	7
10	CD	@card@
fiend	NN	fiend
