nobody	NN	nobody
like	IN	like
merit	NN	merit
but	CC	but
sense	NN	sense
humor	NN	humor
enjoy	VBP	enjoy
schlock	JJ	schlock
mst3	NN	<unknown>
quality	NN	quality
ranks	VBZ	rank
up	RP	up
"	''	"
road	NN	road
house	NN	house
"	''	"
preposterous	JJ	preposterous
characters	NNS	character
sets	VBZ	set
story	NN	story
line	NN	line
bad	JJ	bad
writing	NN	writing
really	RB	really
cracked	VBD	crack
up	RP	up
"	``	"
i	NNS	i
want	VBP	want
dust	NN	dust
guys	NNS	guy
off	IN	off
"	``	"
instead	RB	instead
"	''	"
dust	NN	dust
guys	NNS	guy
"	''	"
f	SYM	f
14s	JJ	<unknown>
carrier	NN	carrier
but	CC	but
formation	NN	formation
they	PP	they
're	VBP	be
f	NN	f
16s	JJ	<unknown>
hint	NN	hint
anger	NN	anger
skepticism	NN	skepticism
segal	NN	<unknown>
goes	VBZ	go
work	VB	work
general	JJ	general
minutes	NNS	minute
overseeing	VBG	oversee
covert	JJ	covert
"	``	"
mind	NN	mind
wipe	VB	wipe
"	``	"
seagal	JJ	<unknown>
segal	NN	<unknown>
runs	VBZ	run
bullets	NNS	bullet
resorts	NNS	resort
knife	VBP	knife
kill	VB	kill
guards	NNS	guard
naturally	RB	naturally
guards	VBZ	guard
all	DT	all
drop	NN	drop
guns	VBZ	gun
fight	NN	fight
knives	NNS	knife
too	RB	too
hand	NN	hand
grenade	NN	grenade
dud	NN	dud
but	CC	but
explodes	VBZ	explode
little	JJ	little
stealth	NN	stealth
fighter	NN	fighter
fly	VBP	fly
all	DT	all
way	NN	way
california	NN	<unknown>
afganistan	NN	<unknown>
refueling	VBG	refuel
segal	JJ	<unknown>
flies	NNS	fly
california	NN	<unknown>
long	JJ	long
way	NN	way
e	SYM	e
way	NN	way
europe	NN	<unknown>
though	IN	though
there	EX	there
's	VBZ	be
carrier	NN	carrier
giving	VBG	give
air	NN	air
support	NN	support
20	CD	@card@
minutes	NNS	minute
away	RB	away
arabian	JJ	Arabian
sea	NN	sea
cic	JJ	<unknown>
carrier	NN	carrier
consists	VBZ	consist
3	CD	3
black	JJ	black
pcs	NNS	<unknown>
2	CD	2
flat	JJ	flat
screen	NN	screen
tvs	NNS	<unknown>
pictures	NNS	picture
gauges	VBZ	gauge
maps	NNS	map
walls	NNS	wall
hoot	VBP	hoot
