this	DT	this
excellent	JJ	excellent
sad	JJ	sad
truth	NN	truth
culture	NN	culture
tends	VBZ	tend
clash	NN	clash
sexes	NNS	sex
just	RB	just
big	JJ	big
warm	JJ	warm
fuzzy	JJ	fuzzy
type	NN	type
master	NN	master
steeped	VBD	steep
tradition	NN	tradition
kind	NN	kind
hearted	VBD	heart
way	NN	way
doggie	NN	doggie
despite	IN	despite
girl	NN	girl
thing	NN	thing
win	VB	win
affections	NNS	affection
top	JJ	top
cute	JJ	cute
monkey	NN	monkey
thousand	CD	thousand
facial	JJ	facial
expressions	NNS	expression
equals	VBZ	equal
big	JJ	big
happy	JJ	happy
end	NN	end
does	VBZ	do
good	JJ	good
job	NN	job
showing	VBG	show
steeped	VBN	steep
tradition	NN	tradition
steeped	VBD	steep
willing	JJ	willing
die	NN	die
sharing	VBG	share
secrets	NNS	secret
sides	NNS	side
culture	NN	culture
never	RB	never
seen	VBN	see
helps	NNS	help
enhance	VBP	enhance
drama	NN	drama
unfolds	VBZ	unfold
near	IN	near
end	NN	end
picture	NN	picture
cinema	NN	cinema
photography	NN	photography
excellent	JJ	excellent
particular	JJ	particular
opening	NN	opening
parade	NN	parade
sequence	NN	sequence
all	DT	all
sparkers	NNS	<unknown>
bound	VBN	bind
oscar	NN	oscar
contention	NN	contention
best	JJS	good
foreign	JJ	foreign
film	NN	film
