"	``	"
masks	NNS	mask
"	''	"
moving	VBG	move
film	NN	film
works	VBZ	work
many	JJ	many
levels	NNS	level
simplest	JJS	simple
haunting	NN	haunting
story	NN	story
street	NN	street
performer	NN	performer
bonds	NNS	bond
young	JJ	young
child	NN	child
while	IN	while
trying	VBG	try
pass	VB	pass
creative	JJ	creative
art	NN	art
masks	NNS	mask
generation	NN	generation
although	IN	although
times	NNS	time
story	NN	story
makes	VBZ	make
old	JJ	old
man	NN	man
job	NN	job
well	RB	well
crafted	VBD	craft
written	JJ	written
acted	VBD	act
directed	JJ	directed
wonderful	JJ	wonderful
production	NN	production
values	VBZ	value
easy	JJ	easy
plight	NN	plight
hang	NN	hang
film	NN	film
ultimately	RB	ultimately
very	RB	very
sweet	JJ	sweet
uplifting	VBG	uplift
kudos	NN	kudos
all	DT	all
wonderful	JJ	wonderful
film	NN	film
children	NNS	child
as	RB	as
well	RB	well
as	IN	as
adults	NNS	adult
trick	VBP	trick
americans	NNS	American
not	RB	not
like	IN	like
foreign	JJ	foreign
language	NN	language
films	NNS	film
