this	DT	this
good	JJ	good
story	NN	story
nice	JJ	nice
pace	NN	pace
all	DT	all
characters	NNS	character
developed	VBD	develop
cool	JJ	cool
i	NNS	i
've	VBP	have
watched	VBN	watch
whole	JJ	whole
bunch	NN	bunch
weeks	NNS	week
best	RBS	well
i	NNS	i
've	VBP	have
seen	VBN	see
weeks	NNS	week
jason	NN	<unknown>
bigg	NN	<unknown>
's	VBZ	be
character	NN	character
best	RBS	well
though	RB	though
though	RB	though
small	JJ	small
cleverly	RB	cleverly
crafted	VBN	craft
very	RB	very
beginning	VBG	begin
romantic	JJ	romantic
comedy	NN	comedy
do	VBP	do
n't	RB	n't
like	VB	like
most	RBS	most
but	RB	but
writing	VBG	write
direction	NN	direction
performing	VBG	perform
sound	JJ	sound
design	NN	design
overall	RB	overall
all	DT	all
capacity	NN	capacity
just	RB	just
really	RB	really
thought	VBD	think
pretty	RB	pretty
cool	JJ	cool
film	NN	film
scored	VBD	score
pretty	RB	pretty
high	JJ	high
all	DT	all
movie	NN	movie
's	POS	's
i	NNS	i
've	VBP	have
seen	VBN	see
lately	RB	lately
rest	NN	rest
big	JJ	big
budget	NN	budget
better	RBR	well
publicized	JJ	publicized
good	JJ	good
job	NN	job
writing	VBG	write
