i	NNS	i
'm	VBP	be
grateful	JJ	grateful
cesar	NN	<unknown>
montano	NN	<unknown>
crew	NN	crew
reviving	VBG	revive
moribund	JJ	moribund
visayan	JJ	Visayan
film	NN	film
understorey	NN	<unknown>
"	``	"
panaghoy	NN	<unknown>
"	''	"
hopefully	RB	hopefully
forerunner	NN	forerunner
resurgence	NN	resurgence
vernacular	NN	vernacular
claims	VBZ	claim
more	JJR	more
speakers	NNS	speaker
than	IN	than
tagalog	NN	<unknown>
dialect	NN	dialect
lifestyle	NN	lifestyle
details	NNS	detail
accurately	RB	accurately
reminiscent	JJ	reminiscent
region	NN	region
philippines	NNS	Philippine
downside	JJ	downside
corny	JJ	corny
stilted	JJ	stilted
acting	JJ	acting
american	NN	American
antagonist	NN	antagonist
item	NN	item
did	VBD	do
n't	RB	n't
appreciate	VB	appreciate
lack	NN	lack
authenticity	NN	authenticity
"	``	"
period	NN	period
"	''	"
costume	JJ	costume
character	NN	character
all	DT	all
bright	JJ	bright
red	JJ	red
kit	NN	kit
car	NN	car
suppose	VBP	suppose
meant	VBN	mean
pass	NN	pass
1930s	NNS	1930s
roadster	NN	roadster
small	JJ	small
yet	CC	yet
glaring	JJ	glaring
details	NNS	detail
"	``	"
panaghoy	NN	<unknown>
"	''	"
would	MD	would
've	VBP	have
least	JJS	least
9	CD	9
10	CD	@card@
rating	NN	rating
daghang	NN	<unknown>
salamat	NN	<unknown>
manoy	NN	<unknown>
cesar	NN	<unknown>
addendum	NN	addendum
film	NN	film
sure	RB	sure
beats	VBZ	beat
peque	NN	<unknown>
gallaga	NN	<unknown>
's	POS	's
"	``	"
oro	NN	<unknown>
plata	NN	Plata
mata	NNS	<unknown>
"	``	"
provided	VBD	provide
different	JJ	different
view	NN	view
visayas	NNS	<unknown>
second	JJ	second
world	NN	world
war	NN	war
alos	NNS	<unknown>
parts	NNS	part
cinematography	NN	cinematography
harks	VBZ	hark
spielberg	NP	Spielberg
's	POS	's
"	``	"
the	DT	the
color	JJ	color
purple	JJ	purple
"	``	"
storyline	NN	storyline
begins	VBZ	begin
reminiscent	JJ	reminiscent
"	``	"
noli	NN	<unknown>
tangere	NN	<unknown>
"	''	"
