pathetic	JJ	pathetic
worse	JJR	bad
than	IN	than
bad	JJ	bad
tv	NN	tv
ca	MD	ca
n't	RB	n't
believe	VB	believe
spacey	NP	spacey
freeman	NN	freeman
flick	NN	flick
reason	NN	reason
morgan	NN	<unknown>
freeman	NN	freeman
's	POS	's
character	NN	character
constantly	RB	constantly
talking	VBG	talk
saying	VBG	say
"	``	"
pussy	JJ	pussy
"	''	"
referring	VBG	refer
nsync	NN	<unknown>
boy	NN	boy
's	POS	's
girlfriend	NN	girlfriend
morgan	NN	<unknown>
freeman	NN	freeman
calling	VBG	call
women	NNS	woman
"	``	"
pussy	JJ	pussy
"	''	"
just	RB	just
awkward	JJ	awkward
hell	NN	hell
people	NNS	people
film	NN	film
thinking	VBG	think
too	RB	too
many	JJ	many
plot	NN	plot
holes	NNS	hole
imagine	VBP	imagine
combined	JJ	combined
horrid	JJ	horrid
acting	JJ	acting
confusing	JJ	confusing
camera	NN	camera
angles	NNS	angle
lame	JJ	lame
script	NN	script
cheap	JJ	cheap
background	NN	background
music	NN	music
absolutely	RB	absolutely
unbearable	JJ	unbearable
rented	VBN	rent
flop	NN	flop
low	JJ	low
expectations	NNS	expectation
but	CC	but
well	RB	well
really	RB	really
sucked	VBN	suck
