superdome	NN	<unknown>
makes	NNS	make
wonder	VBP	wonder
whole	JJ	whole
plot	NN	plot
concerns	NNS	concern
trying	VBG	try
sabotage	NN	sabotage
superbowl	NN	<unknown>
all	RB	all
attempts	VBZ	attempt
stop	VB	stop
tom	NN	tom
selleck	NN	<unknown>
donna	NN	<unknown>
mills	NNS	mill
'	POS	'
careers	NNS	career
managed	VBD	manage
survive	VB	survive
however	RB	however
most	JJS	most
frustrating	JJ	frustrating
thing	NN	thing
was	VBD	be
no	DT	no
football	NN	football
all	RB	all
avoid	VB	avoid
possible	JJ	possible
