like	IN	like
arabian	JJ	Arabian
nights	NNS	night
film	NN	film
plays	VBZ	play
storytelling	NN	storytelling
conventions	NNS	convention
order	NN	order
make	VBP	make
feel	VB	feel
there	EX	there
's	VBZ	be
plot	NN	plot
plot	NN	plot
more	JJR	more
plot	NN	plot
opens	VBZ	open
appears	VBZ	appear
frame	NN	frame
device	NN	device
blind	JJ	blind
man	NN	man
telling	VBG	tell
story	NN	story
life	NN	life
plunges	NNS	plunge
flashback	NN	flashback
takes	VBZ	take
right	RB	right
up	RB	up
blind	JJ	blind
man	NN	man
's	POS	's
present	JJ	present
discover	VBP	discover
half	DT	half
story	NN	story
yet	RB	yet
come	VB	come
admitted	VBN	admit
second	JJ	second
half	NN	half
does	VBZ	do
n't	RB	n't
quite	RB	quite
live	VB	live
up	RP	up
promise	NN	promise
like	IN	like
arabian	JJ	Arabian
nights	NNS	night
tries	VBZ	try
cram	NN	cram
as	IN	as
many	JJ	many
middle	JJ	middle
eastern	JJ	eastern
folk	NN	folk
motiffs	NNS	<unknown>
as	IN	as
possible	JJ	possible
work	NN	work
freed	VBD	free
genie	NN	genie
beautiful	JJ	beautiful
princess	NN	princess
flying	VBG	fly
carpet	NN	carpet
fantastic	JJ	fantastic
mechanical	JJ	mechanical
toys	NNS	toy
sea	NN	sea
voyages	VBZ	voyage
crowded	JJ	crowded
marketplace	NN	marketplace
wicked	JJ	wicked
vizier	NN	vizier
jewels	NNS	jewel
do	VBP	do
n't	RB	n't
know	VB	know
all	DT	all
works	NNS	work
but	CC	but
does	VBZ	do
just	RB	just
beautiful	JJ	beautiful
sets	NNS	set
beautiful	JJ	beautiful
june	NN	June
duprez	NN	<unknown>
beautiful	JJ	beautiful
rozsa	NN	<unknown>
's	POS	's
score	NN	score
especially	RB	especially
beautiful	JJ	beautiful
as	IN	as
usual	JJ	usual
sounds	NNS	sound
hungarian	NN	Hungarian
but	CC	but
manages	VBZ	manage
convince	VB	convince
he	PP	he
's	POS	's
hungarian	JJ	Hungarian
persian	JJ	Persian
way	NN	way
