even	RB	even
early	JJ	early
career	NN	career
capra	NN	<unknown>
quite	RB	quite
accomplished	VBN	accomplish
camera	NN	camera
work	NN	work
timing	NN	timing
thin	JJ	thin
story	NN	story
quite	RB	quite
predictable	JJ	predictable
times	NNS	time
but	CC	but
gets	VBZ	get
very	RB	very
good	JJ	good
performances	NNS	performance
cast	VBD	cast
intricate	JJ	intricate
camera	NN	camera
moves	NNS	move
involve	VBP	involve
viewer	NN	viewer
intimately	RB	intimately
looks	VBZ	look
like	IN	like
cinderella	NN	Cinderella
story	NN	story
though	IN	though
brains	NNS	brain
fall	VBP	fall
rich	JJ	rich
'	''	'
prince	NN	prince
'	''	'
lose	VB	lose
fortune	NN	fortune
nonetheless	RB	nonetheless
good	JJ	good
cast	NN	cast
fast	JJ	fast
pace	NN	pace
it	PP	it
's	VBZ	be
easy	RB	easy
caught	VBN	catch
up	IN	up
clichs	NNS	<unknown>
does	VBZ	do
more	RBR	more
original	JJ	original
as	IN	as
married	JJ	married
couple	NN	couple
way	NN	way
make	VBP	make
living	NN	living
ending	VBG	end
very	RB	very
predictable	JJ	predictable
but	CC	but
satisfying	JJ	satisfying
want	VBP	want
compliment	NN	compliment
title	NN	title
writing	VBG	write
very	RB	very
witty	JJ	witty
fun	NN	fun
