it	PP	it
's	VBZ	be
bit	NN	bit
easy	JJ	easy
that	WDT	that
's	VBZ	be
graphics	NNS	graphics
clean	VB	clean
realistic	JJ	realistic
except	IN	except
fact	NN	fact
fences	NNS	fence
2d	JJ	<unknown>
but	CC	but
that	WDT	that
's	VBZ	be
forgiveable	JJ	<unknown>
rest	NN	rest
graphics	NNS	graphics
cleaner	JJR	clean
than	IN	than
goldeneye	NNS	goldeneye
many	JJ	many
n64	NN	<unknown>
games	NNS	game
sounds	VBZ	sound
magnificant	JJ	<unknown>
speaking	VBG	speak
sfx	NN	<unknown>
pleasant	JJ	pleasant
realistic	JJ	realistic
camera	NN	camera
angle	NN	angle
bit	NN	bit
frustrating	JJ	frustrating
times	NNS	time
but	CC	but
it	PP	it
's	POS	's
platform	NN	platform
game	NN	game
like	IN	like
banjo	NN	banjo
kazooie	NN	<unknown>
donkey	NN	donkey
kong	NP	Kong
64	CD	@card@
got	VBD	get
game	NN	game
as	IN	as
christmas	NNS	<unknown>
present	JJ	present
1997	CD	@card@
dutifully	RB	dutifully
gotten	VBN	get
120	CD	@card@
stars	NNS	star
10	CD	@card@
times	NNS	time
