never	RB	never
viewed	VBN	view
film	NN	film
enjoyed	VBD	enjoy
singing	VBG	sing
dancing	NN	dancing
cagney	NN	Cagney
cast	NN	cast
members	NNS	member
dick	NN	dick
powell	NP	Powell
scott	NP	Scott
blair	NP	Blair
great	JJ	great
tenor	NN	tenor
voice	NN	voice
ruby	JJ	ruby
keeler	NN	<unknown>
bea	NN	<unknown>
thorn	NN	thorn
james	NNS	<unknown>
cagney	NN	Cagney
plays	VBZ	play
role	NN	role
as	IN	as
chester	NN	<unknown>
kent	VBD	ken
writes	VBZ	write
musicals	NNS	musical
eventually	RB	eventually
goes	VBZ	go
producing	VBG	produce
prologues	NNS	prologue
shown	VBN	show
feature	NN	feature
films	NNS	film
shown	VBN	show
theater	NN	theater
's	POS	's
1930	CD	@card@
's	POS	's
chester	NN	<unknown>
trouble	NN	trouble
people	NNS	people
trying	VBG	try
steal	VB	steal
ideas	NNS	idea
shows	VBZ	show
very	RB	very
entertaining	JJ	entertaining
film	NN	film
lots	NNS	lot
comedy	NN	comedy
plenty	NN	plenty
laughs	VBZ	laugh
joan	JJ	<unknown>
blondell	NN	<unknown>
nan	NN	nan
prescott	NN	<unknown>
gave	VBD	give
great	JJ	great
supporting	VBG	support
role	NN	role
very	RB	very
young	JJ	young
pretty	JJ	pretty
dick	NN	dick
powell	NN	<unknown>
great	JJ	great
as	IN	as
singer	NN	singer
dancer	NN	dancer
just	RB	just
starting	VBG	start
long	JJ	long
successful	JJ	successful
screen	NN	screen
career	NN	career
enjoy	VBP	enjoy
