this	DT	this
full	JJ	full
action	NN	action
needed	VBD	need
make	VB	make
awsome	JJ	<unknown>
but	CC	but
best	RBS	well
all	RB	all
actually	RB	actually
plot	VB	plot
unlike	IN	unlike
new	JJ	new
reality	NN	reality
shows	VBZ	show
transgenic	JJ	transgenic
girl	NN	girl
escapes	VBZ	escape
military	JJ	military
holding	NN	holding
base	NN	base
totally	RB	totally
suggest	VBP	suggest
bying	NN	<unknown>
dvds	NNS	<unknown>
i	NNS	i
've	VBP	have
preordered	VBN	<unknown>
suggest	VBP	suggest
