i	NNS	i
love	VBP	love
mean	JJ	mean
story	NN	story
not	RB	not
best	JJS	good
but	CC	but
dancing	VBG	dance
most	RBS	most
certainly	RB	certainly
makes	VBZ	make
up	RB	up
know	VB	know
little	JJ	little
bit	NN	bit
character	NN	character
way	NN	way
want	VBP	want
learn	VBP	learn
just	RB	just
think	VB	think
wo	MD	wo
n't	RB	n't
like	VB	like
unless	IN	unless
you	PP	you
're	VBP	be
broadway	JJ	Broadway
