spacecamp	NN	<unknown>
kids	NNS	kid
just	RB	just
love	VBP	love
mom	NN	mom
dad	NN	dad
fun	NN	fun
watching	VBG	watch
as	IN	as
well	RB	well
growing	VBG	grow
up	RP	up
80	CD	@card@
's	VBZ	be
enjoyed	VBN	enjoy
it	PP	it
's	VBZ	be
plot	NN	plot
all	DT	all
actors	NNS	actor
recently	RB	recently
purchased	VBN	purchase
dvd	NN	<unknown>
kids	NNS	kid
able	JJ	able
as	IN	as
much	JJ	much
fun	NN	fun
watching	NN	watching
as	RB	as
did	VBD	do
plot	NN	plot
fun	NN	fun
group	NN	group
kids	NNS	kid
embark	VBP	embark
journey	NN	journey
never	RB	never
expected	VBD	expect
rocketed	VBN	rocket
space	NN	space
overachieving	VBG	overachieve
robot	NN	robot
auh	NNS	<unknown>
but	CC	but
realized	VBN	realize
did	VBD	do
n't	RB	n't
enough	JJ	enough
oxygen	NN	oxygen
make	VB	make
panic	NN	panic
sunk	NN	sunk
recovered	VBD	recover
enough	JJ	enough
oxygen	NN	oxygen
space	NN	space
station	NN	station
returned	VBD	return
earth	NN	earth
as	IN	as
better	JJR	good
friends	NNS	friend
new	JJ	new
respect	NN	respect
life	NN	life
