when	WRB	when
came	VBD	come
6	CD	6
months	NNS	month
tragedy	NN	tragedy
did	VBD	do
n't	RB	n't
want	VB	want
did	VBD	do
n't	RB	n't
want	VB	want
open	JJ	open
old	JJ	old
wounds	NNS	wound
regretted	VBD	regret
seen	VBN	see
thank	VBP	thank
god	NN	god
did	VBD	do
shows	NNS	show
bravery	NN	bravery
all	DT	all
fdny	JJ	<unknown>
nypd	NN	<unknown>
salute	NN	salute
offered	VBD	offer
closure	NN	closure
life	NN	life
