a	DT	a
classic	JJ	classic
cartoon	NN	cartoon
always	RB	always
enjoyable	JJ	enjoyable
funny	JJ	funny
interesting	JJ	interesting
plot	NN	plot
complete	VB	complete
lovable	JJ	lovable
characters	NNS	character
road	NN	road
rovers	NNS	rover
worth	NN	worth
seeing	VBG	see
short	RB	short
13	CD	@card@
episodes	NNS	episode
manage	VBP	manage
chance	NN	chance
unfortunately	RB	unfortunately
very	RB	very
hard	RB	hard
think	VB	think
warner	NN	warner
brothers	NNS	brother
studios	NNS	studio
release	NN	release
dvd	NN	<unknown>
contains	VBZ	contain
all	DT	all
13	CD	@card@
episodes	NNS	episode
definitely	RB	definitely
buy	VBP	buy
did	VBD	do
buy	VB	buy
too	RB	too
kids	NNS	kid
like	IN	like
dogs	NNS	dog
love	VBP	love
road	NN	road
rovers	NNS	rover
road	NN	road
rovers	NNS	rover
gotten	VBN	get
more	JJR	more
attention	NN	attention
while	NN	while
aired	VBD	air
definitely	RB	definitely
original	JJ	original
very	RB	very
special	JJ	special
appreciated	VBD	appreciate
much	RB	much
more	JJR	more
than	IN	than
