i	NP	i
saw	VBD	see
film	NN	film
1980	CD	@card@
midday	NN	midday
spot	NN	spot
many	JJ	many
subsequent	JJ	subsequent
viewings	NNS	viewing
purchase	NN	purchase
video	NN	video
still	RB	still
makes	VBZ	make
laugh	VB	laugh
loud	RB	loud
yes	RB	yes
it	PP	it
's	VBZ	be
relic	NN	relic
age	NN	age
domestic	JJ	domestic
comedy	NN	comedy
set	VBD	set
affluent	JJ	affluent
middle	JJ	middle
class	NN	class
america	NN	<unknown>
but	CC	but
well	RB	well
executed	VBD	execute
well	RB	well
executed	VBN	execute
but	CC	but
it	PP	it
's	POS	's
document	NN	document
age	NN	age
celebration	NN	celebration
post	NN	post
war	NN	war
optimism	NN	optimism
baby	NN	baby
boom	NN	boom
nascent	JJ	nascent
consumer	NN	consumer
age	NN	age
film	NN	film
no	DT	no
"	``	"
guilty	JJ	guilty
"	''	"
pleasure	NN	pleasure
wonderful	JJ	wonderful
sophisticated	JJ	sophisticated
leads	NNS	lead
actors	NNS	actor
urbane	JJ	urbane
melvyn	NP	Melvyn
douglas	NNS	<unknown>
bemused	VBD	bemuse
cary	JJ	<unknown>
grant	NN	grant
daffily	RB	<unknown>
determined	VBN	determine
myrna	NN	<unknown>
loy	NN	<unknown>
complement	VB	complement
memorable	JJ	memorable
team	NN	team
characters	NNS	character
favourite	JJ	favourite
scenes	NNS	scene
"	''	"
it	PP	it
means	VBZ	mean
gotta	VBN	gotta
blast	NN	blast
"	''	"
"	``	"
miss	NN	miss
stellwaggen	NN	<unknown>
"	''	"
"	''	"
this	DT	this
little	JJ	little
piggy	NN	piggy
"	''	"
love	NN	love
