glacier	NN	glacier
fox	NNS	fox
most	RBS	most
heartrending	JJ	heartrending
wonderfully	RB	wonderfully
photographed	VBN	photograph
wildlife	NN	wildlife
films	NNS	film
film	NN	film
makes	VBZ	make
care	NN	care
member	NN	member
fox	NN	fox
family	NN	family
blind	JJ	blind
cub	NN	cub
strongest	JJS	strong
adventures	NNS	adventure
times	CC	times
hilarious	JJ	hilarious
tragic	JJ	tragic
set	NN	set
against	IN	against
inhospitable	JJ	inhospitable
countryside	NN	countryside
audience	NN	audience
's	POS	's
hearts	NNS	heart
warm	JJ	warm
family	NN	family
members	NNS	member
music	NN	music
score	NN	score
lyrics	NNS	lyric
tell	VBP	tell
story	NN	story
intercut	VBD	intercut
narration	NN	narration
happening	VBG	happen
general	JJ	general
terms	NNS	term
man	NN	man
remains	VBZ	remain
biggest	JJS	big
predators	NNS	predator
but	CC	but
left	VBD	leave
no	DT	no
doubt	NN	doubt
foxes	VBZ	fox
capable	JJ	capable
living	NN	living
not	RB	not
just	RB	just
surviving	VBG	survive
human	JJ	human
endeavours	NNS	endeavour
