spoilers	NNS	spoiler
very	RB	very
moment	NN	moment
saw	VBD	see
local	JJ	local
film	NN	film
critic	NN	critic
trash	NN	trash
review	NN	review
10	CD	@card@
00	CD	@card@
news	NN	news
wanted	VBD	want
do	VB	do
n't	RB	n't
remember	VB	remember
local	JJ	local
omaha	NN	Omaha
newscast	NN	newscast
carried	VBD	carry
review	NN	review
but	CC	but
critic	NN	critic
very	RB	very
insistent	JJ	insistent
film	NN	film
way	NN	way
too	RB	too
sleazy	JJ	sleazy
average	JJ	average
church	NN	church
going	VBG	go
nebraskan	NN	<unknown>
showed	VBD	show
snippet	NN	snippet
scene	NN	scene
john	NN	john
glover	NN	glover
kidnap	VB	kidnap
ann	NP	Ann
margret	NN	<unknown>
she	PP	she
's	VBZ	be
swimming	VBG	swim
pool	NN	pool
glover	NN	glover
's	POS	's
character	NN	character
commending	VBG	commend
nice	JJ	nice
body	NN	body
forth	IN	forth
using	VBG	use
many	JJ	many
words	NNS	word
local	JJ	local
station	NN	station
felt	VBN	feel
necessary	JJ	necessary
edit	VBP	edit
hooked	JJ	hooked
problem	NN	problem
though	IN	though
13	CD	@card@
years	NNS	year
old	JJ	old
time	NN	time
wait	NN	wait
year	NN	year
came	VBD	come
cable	NN	cable
let	NN	let
's	POS	's
just	RB	just
say	VBP	say
worth	JJ	worth
wait	NN	wait
guilty	JJ	guilty
pleasure	NN	pleasure
film	NN	film
sleazy	JJ	sleazy
huge	JJ	huge
understatement	NN	understatement
film	NN	film
centers	VBZ	center
successful	JJ	successful
businessman	NN	businessman
blackmailed	VBD	blackmail
small	JJ	small
time	NN	time
scumbags	NNS	<unknown>
affair	NN	affair
young	JJ	young
woman	NN	woman
roy	NP	Roy
scheider	NP	Scheider
as	IN	as
effective	NN	effective
as	RB	as
plays	VBZ	play
poor	JJ	poor
guy	NN	guy
just	RB	just
wanted	VBD	want
little	JJ	little
fling	NN	fling
finds	VBZ	find
himself	PP	himself
mercy	NN	mercy
terrific	JJ	terrific
villains	NNS	villain
john	NN	john
glover	NN	glover
's	VBZ	be
character	NN	character
most	RBS	most
memorable	JJ	memorable
scumbags	NNS	<unknown>
all	DT	all
time	NN	time
he	PP	he
's	VBZ	be
sleazy	JJ	sleazy
funny	JJ	funny
times	NNS	time
always	RB	always
brink	NN	brink
doing	VBG	do
crazy	JJ	crazy
there	EX	there
's	VBZ	be
robert	NN	<unknown>
trebor	NN	<unknown>
's	POS	's
nice	JJ	nice
way	NN	way
character	NN	character
leo	NN	<unknown>
clearly	RB	clearly
head	JJ	head
blackmail	NN	blackmail
scheme	NN	scheme
whimpering	NN	whimpering
sweating	VBG	sweat
coward	NN	coward
runs	VBZ	run
peep	NN	peep
place	NN	place
live	VBP	live
nude	JJ	nude
models	NNS	model
clarence	NN	clarence
williams	NP	Williams
iii	NP	<unknown>
as	IN	as
bobby	NN	bobby
shy	JJ	shy
brooding	VBG	brood
sociopath	NN	sociopath
afraid	JJ	afraid
good	JJ	good
reason	NN	reason
forget	VB	forget
wake	NN	wake
up	RB	up
gives	VBZ	give
vanity	NN	vanity
giant	JJ	giant
teddy	NN	teddy
bear	NN	bear
dealing	VBG	deal
initial	JJ	initial
shock	NN	shock
realizing	VBG	realize
he	PP	he
's	VBZ	be
up	RB	up
against	IN	against
scheider	NP	Scheider
turns	VBZ	turn
tables	NNS	table
creeps	NN	creeps
takes	VBZ	take
control	NN	control
situation	NN	situation
glover	NN	glover
goes	VBZ	go
wife	NN	wife
conflict	NN	conflict
played	VBD	play
brutally	RB	brutally
virtually	RB	virtually
entire	JJ	entire
cast	NN	cast
getting	VBG	get
shot	NN	shot
raped	VBD	rape
blown	VBN	blow
up	RP	up
do	VBP	do
n't	RB	n't
know	VB	know
love	NN	love
much	RB	much
really	RB	really
creep	VB	creep
but	CC	but
does	VBZ	do
n't	RB	n't
maybe	RB	maybe
it	PP	it
's	VBZ	be
characters	NNS	character
all	DT	all
interesting	JJ	interesting
story	NN	story
takes	VBZ	take
plenty	JJ	plenty
chances	NNS	chance
most	JJS	most
films	NNS	film
today	NN	today
never	RB	never
try	VBP	try
it	PP	it
's	VBZ	be
scary	JJ	scary
think	VB	think
adult	JJ	adult
film	NN	film
industry	NN	industry
probably	RB	probably
more	RBR	more
than	IN	than
few	JJ	few
characters	NNS	character
like	IN	like
glover	NN	glover
's	POS	's
running	VBG	run
l	NN	l
looking	VBG	look
trouble	NN	trouble
just	RB	just
thinking	VBG	think
voice	NN	voice
enough	RB	enough
make	VBP	make
chuckle	VB	chuckle
"	``	"
hey	UH	hey
sport	NN	sport
nice	JJ	nice
day	NN	day
"	''	"
this	DT	this
film	NN	film
plenty	NN	plenty
shootouts	NNS	shootout
cool	VBP	cool
cars	NNS	car
great	JJ	great
dialog	NN	dialog
like	IN	like
line	NN	line
opening	NN	opening
statement	NN	statement
decent	JJ	decent
acting	VBG	act
plenty	NN	plenty
cameos	NNS	cameo
real	JJ	real
life	NN	life
porno	NN	porno
stars	NNS	star
look	VBP	look
ron	JJ	<unknown>
jeremy	NN	<unknown>
frolicking	VBG	frolick
hot	JJ	hot
tub	NN	tub
chicks	NNS	chick
party	NN	party
scene	NN	scene
glover	NN	glover
's	POS	's
place	NN	place
thing	NN	thing
add	VBP	add
hot	JJ	hot
women	NNS	woman
film	NN	film
wow	NN	wow
travolta	NN	<unknown>
did	VBD	do
right	RB	right
marrying	VBG	marry
kelly	JJ	<unknown>
preston	NN	<unknown>
yum	NN	<unknown>
vanity	NN	vanity
nude	JJ	nude
time	NN	time
born	VBN	bear
again	RB	again
christian	JJ	Christian
ann	NP	Ann
margret	NN	<unknown>
say	VBP	say
except	IN	except
quintessential	JJ	quintessential
american	NN	American
beauty	NN	beauty
9	CD	9
10	CD	@card@
stars	NNS	star
sayeth	JJ	<unknown>
hound	NN	hound
added	VBD	add
feb	NN	Feb
14	CD	@card@
2008	CD	@card@
rip	NN	rip
roy	NP	Roy
scheider	NP	Scheider
