this	DT	this
just	RB	just
plain	JJ	plain
dumb	JJ	dumb
casting	NN	casting
ralph	NN	<unknown>
meeker	JJR	meek
as	IN	as
mike	NN	mike
hammer	NN	hammer
fatuous	JJ	fatuous
climax	NN	climax
film	NN	film
exercise	NN	exercise
wooden	JJ	wooden
predictability	NN	predictability
mike	NN	mike
hammer	NN	hammer
detective	NN	detective
fiction	NN	fiction
's	POS	's
true	JJ	true
sociopaths	NNS	sociopath
unlike	IN	unlike
marlow	NP	Marlow
spade	NN	spade
pieces	NNS	piece
solve	VB	solve
mystery	NN	mystery
hammer	NN	hammer
breaks	VBZ	break
things	NNS	thing
apart	RB	apart
to	TO	to
truth	NN	truth
film	NN	film
turns	VBZ	turn
hammer	NN	hammer
boob	NN	boob
surrounding	VBG	surround
bad	JJ	bad
guys	NNS	guy
well	RB	well
too	RB	too
dumb	JJ	dumb
away	RB	away
poorly	RB	poorly
drawn	JJ	drawn
succumbs	VBZ	succumb
popcorn	NN	popcorn
attack	NN	attack
parts	NNS	part
right	JJ	right
stooges	NNS	stooge
play	VBP	play
book	NN	book
velda	NN	<unknown>
's	POS	's
dance	NN	dance
barre	NN	barre
instance	NN	instance
bad	JJ	bad
guy	NN	guy
accidentally	RB	accidentally
stabs	VBZ	stab
boss	NN	boss
the	DT	the
continuity	NN	continuity
breaks	VBZ	break
shameful	JJ	shameful
frau	NN	Frau
blucher	NN	blucher
running	VBG	run
centerline	NN	centerline
road	NN	road
camera	NN	camera
tight	RB	tight
lower	JJR	low
legs	NNS	leg
but	CC	but
she	PP	she
's	POS	's
way	NN	way
camera	NN	camera
pulls	VBZ	pull
wider	JJR	wide
shot	VBD	shoot
worst	JJS	bad
break	NN	break
however	RB	however
precedes	VBZ	precede
popcorn	NN	popcorn
attack	NN	attack
bad	JJ	bad
guy	NN	guy
stalking	VBG	stalk
hammer	NN	hammer
passes	VBZ	pass
clock	NN	clock
seconds	NNS	second
hero	NN	hero
except	IN	except
clock	NN	clock
shows	VBZ	show
seven	CD	seven
minutes	NNS	minute
guy	NN	guy
fair	JJ	fair
interesting	JJ	interesting
camera	NN	camera
angles	NNS	angle
lighting	VBG	light
grand	JJ	grand
finale	NN	finale
bad	JJ	bad
seen	VBN	see
reason	NN	reason
gets	VBZ	get
points	NNS	point
10	CD	@card@
