the	DT	the
tarzan	JJ	<unknown>
film	NN	film
starring	VBG	star
johnny	NN	johnny
weissmuller	NN	<unknown>
looking	VBG	look
surprisingly	RB	surprisingly
aged	VBN	age
year	NN	year
"	``	"
tarzan	NN	<unknown>
huntress	NN	huntress
"	``	"
bad	JJ	bad
spite	NN	spite
all	DT	all
trivia	NN	trivia
add	VBP	add
make	VB	make
look	VB	look
better	RBR	well
obvious	JJ	obvious
rko	NN	<unknown>
tried	VBD	try
make	VB	make
great	JJ	great
farewell	NN	farewell
weissmuller	NN	<unknown>
shooting	VBG	shoot
beautiful	JJ	beautiful
scenery	NN	scenery
mxico	NN	<unknown>
top	JJ	top
star	NN	star
country	NN	country
andrea	NP	Andrea
palma	NP	Palma
multiple	JJ	multiple
award	NN	award
winning	VBG	win
cinematographer	NN	cinematographer
gabriel	NN	<unknown>
figueroa	NN	<unknown>
bringing	VBG	bring
prestigious	JJ	prestigious
composer	NN	composer
dimitri	NN	<unknown>
tiomkin	NN	<unknown>
score	NN	score
although	IN	although
cost	NN	cost
less	CC	less
filming	VBG	film
abroad	RB	abroad
looks	VBZ	look
more	RBR	more
expensive	JJ	expensive
than	IN	than
any	DT	any
rko	NP	<unknown>
film	NN	film
series	NN	series
taking	VBG	take
advantage	NN	advantage
acapulco	NN	<unknown>
beaches	VBZ	beach
real	JJ	real
pyramids	NNS	pyramid
as	IN	as
aquatania	NN	<unknown>
impressive	JJ	impressive
dcors	NNS	<unknown>
all	DT	all
scenes	NNS	scene
related	VBN	relate
temple	NN	temple
god	NN	god
balu	NN	<unknown>
especially	RB	especially
exterior	JJ	exterior
built	VBN	build
steep	JJ	steep
rocks	NNS	rock
kurt	NN	<unknown>
neumann	NP	Neumann
stayed	VBD	stay
as	IN	as
director	NN	director
instead	RB	instead
robert	NP	Robert
florey	NP	Florey
gives	VBZ	give
very	RB	very
slow	VB	slow
pace	NN	pace
neumann	NNS	<unknown>
fine	JJ	fine
work	NN	work
"	''	"
tarzan	NN	<unknown>
amazons	NNS	amazon
"	''	"
"	``	"
tarzan	JJ	<unknown>
leopard	NN	leopard
woman	NN	woman
"	''	"
"	``	"
tarzan	NN	<unknown>
huntress	NN	huntress
"	``	"
finished	VBD	finish
career	NN	career
directing	VBG	direct
classic	JJ	classic
"	``	"
the	DT	the
fly	NN	fly
"	``	"
year	NN	year
death	NN	death
while	IN	while
florey	NN	<unknown>
television	NN	television
director	NN	director
career	NN	career
few	JJ	few
remarkable	JJ	remarkable
films	NNS	film
weissmuller	NN	<unknown>
looks	VBZ	look
tired	JJ	tired
chimp	NN	chimp
playing	VBG	play
cheeta	NN	<unknown>
not	RB	not
as	RB	as
good	JJ	good
as	IN	as
but	CC	but
worst	JJS	bad
character	NN	character
benji	NN	<unknown>
obnoxious	JJ	obnoxious
mailman	NN	mailman
sings	VBZ	sing
horrendous	JJ	horrendous
songs	NNS	song
caribbean	JJ	Caribbean
air	NN	air
location	NN	location
supposed	VBN	suppose
africa	NP	Africa
shot	NN	shot
mxico	NN	<unknown>
boring	VBG	bore
decidedly	RB	decidedly
dubious	JJ	dubious
taste	NN	taste
sad	JJ	sad
farewell	NN	farewell
weissmuller	NN	<unknown>
's	POS	's
tarzan	NN	<unknown>
