this	DT	this
ranks	VBZ	rank
as	IN	as
worst	JJS	bad
i	NNS	i
've	VBP	have
seen	VBN	see
years	NNS	year
cuba	NN	<unknown>
angie	NN	<unknown>
acting	VBG	act
actually	RB	actually
embarrassing	JJ	embarrassing
was	VBD	be
n't	RB	n't
archer	JJR	arch
decent	JJ	decent
actress	NN	actress
happened	VBD	happen
action	NN	action
decent	JJ	decent
but	CC	but
completely	RB	completely
implausible	JJ	implausible
make	VBP	make
up	RB	up
bad	JJ	bad
it	PP	it
's	VBZ	be
worth	JJ	worth
mentioning	VBG	mention
mean	NN	mean
thinks	VBZ	think
makeup	NN	makeup
contemporary	JJ	contemporary
feature	NN	feature
film	NN	film
tell	VBP	tell
make	VB	make
up	RP	up
artist	NN	artist
dop	NN	<unknown>
you	PP	you
're	VBP	be
not	RB	not
supposed	VBN	suppose
actually	RB	actually
ending	VBG	end
massive	JJ	massive
disappointment	NN	disappointment
lines	NNS	line
"	''	"
and	CC	and
realized	VBD	realize
all	DT	all
dream"do	NN	<unknown>
n't	RB	n't
waste	VB	waste
time	NN	time
money	NN	money
you	PP	you
're	VBP	be
better	RBR	well
just	RB	just
staring	VBG	stare
space	NN	space
2	CD	2
hours	NNS	hour
