so	IN	so
i	NP	i
'm	VBP	be
looking	VBG	look
rent	NN	rent
dvd	NNS	<unknown>
come	VBP	come
called	VBN	call
'	''	'
end	NN	end
game	NN	game
'	POS	'
stars	NNS	star
james	NNS	<unknown>
woods	NNS	wood
cuba	NN	<unknown>
gooding	NN	<unknown>
jr	NN	<unknown>
synopsis	NN	synopsis
taught	VBD	teach
political	JJ	political
thriller	NN	thriller
well	RB	well
worth	JJ	worth
look	NN	look
thought	VBD	think
boy	NN	boy
wrong	JJ	wrong
end	NN	end
game	NN	game
just	RB	just
most	RBS	most
ridiculous	JJ	ridiculous
plot	NN	plot
displeasure	NN	displeasure
enduring	VBG	endure
whodunnit	NN	whodunnit
ca	MD	ca
n't	RB	n't
really	RB	really
tear	VB	tear
as	RB	as
like	JJ	like
'	''	'
ruining	VBG	ruin
'	''	'
yet	RB	yet
experience	NN	experience
monstrosity	NN	monstrosity
but	CC	but
questions	NNS	question
as	RB	as
'	''	'
why	WRB	why
'	POS	'
'	''	'
where	WRB	where
earth	NN	earth
did	VBD	do
resources	NNS	resource
pull	VB	pull
'	''	'
all	DT	all
too	RB	too
abundant	JJ	abundant
following	VBG	follow
film	NN	film
's	VBZ	be
unintentionally	RB	unintentionally
hilarious	JJ	hilarious
conclusion	NN	conclusion
as	IN	as
acting	VBG	act
know	VB	know
films	NNS	film
almost	RB	almost
feel	VBP	feel
actor	NN	actor
's	VBZ	have
realised	VBN	realise
they	PP	they
've	VBP	have
terrible	JJ	terrible
mistake	NN	mistake
signing	NN	signing
shows	VBZ	show
performance	NN	performance
accompany	VB	accompany
laughable	JJ	laughable
script	NN	script
seriously	RB	seriously
flawed	JJ	flawed
irritating	VBG	irritate
direction	NN	direction
recipe	NN	recipe
cinematic	JJ	cinematic
poison	NN	poison
course	NN	course
did	VBD	do
n't	RB	n't
make	VB	make
cinema	NN	cinema
reason	NN	reason
not	RB	not
allow	VB	allow
living	VBG	live
room	NN	room
appalling	JJ	appalling
