wow	NN	wow
great	JJ	great
cast	NN	cast
julia	NN	<unknown>
roberts	VBZ	<unknown>
john	NN	john
cusack	NN	<unknown>
christopher	NN	<unknown>
walken	JJ	<unknown>
catherine	NN	<unknown>
zeta	NN	zeta
jones	NNS	<unknown>
hank	NN	hank
azaria	NN	<unknown>
what	WP	what
's	VBZ	be
script	NN	script
say	VBP	say
you	PP	you
're	VBP	be
just	RB	just
greedy	JJ	greedy
surely	RB	surely
charismatic	JJ	charismatic
bunch	NN	bunch
thespians	NNS	Thespian
weave	VBP	weave
fetching	JJ	fetching
tapestries	NNS	tapestry
cinematic	JJ	cinematic
wonder	NN	wonder
script	NN	script
unnecessary	JJ	unnecessary
you	PP	you
'd	MD	will
think	VB	think
but	CC	but
no	DT	no
america	NN	<unknown>
's	POS	's
sweethearts	NNS	sweetheart
missed	VBD	miss
opportunity	NN	opportunity
it	PP	it
's	VBZ	be
like	IN	like
involved	JJ	involved
woke	VBD	wake
up	RP	up
day	NN	day
's	POS	's
writing	VBG	write
shooting	NN	shooting
editing	VBG	edit
though	IN	though
"	``	"
you	PP	you
know	VBP	know
i	NNS	i
've	VBP	have
working	VBG	work
pretty	RB	pretty
hard	RB	hard
lately	RB	lately
guaranteed	VBN	guarantee
hit	VBD	hit
all	DT	all
big	JJ	big
names	NNS	name
right	JJ	right
i	NNS	i
'm	VBP	be
just	RB	just
gonna	VBG	gonna
cruise	NN	cruise
let	VBD	let
somebody	NN	somebody
carry	VB	carry
"	``	"
much	RB	much
potential	JJ	potential
yet	CC	yet
painful	JJ	painful
sit	NN	sit
is	VBZ	be
n't	RB	n't
single	JJ	single
aspect	NN	aspect
thing	NN	thing
does	VBZ	do
n't	RB	n't
suck	VB	suck
julia	NP	Julia
's	POS	's
fat	JJ	fat
suit	NN	suit
lame	NN	lame
