it	PP	it
is	VBZ	be
n't	RB	n't
pace	NN	pace
pop	NN	pop
actors	NNS	actor
were	VBD	be
n't	RB	n't
afraid	JJ	afraid
chew	NN	chew
scenery	NN	scenery
decent	JJ	decent
script	NN	script
scratching	VBG	scratch
head	NN	head
farrah	NN	<unknown>
is	VBZ	be
n't	RB	n't
really	RB	really
"	``	"
serious	JJ	serious
"	''	"
career	NN	career
does	VBZ	do
manager	NN	manager
wasting	NN	wasting
time	NN	time
kate	NN	<unknown>
barney	NN	barney
"	``	"
artists	NNS	artist
"	''	"
sign	NN	sign
up	IN	up
mother	NN	mother
all	RB	all
jiggle	VB	jiggle
shows	NNS	show
like	IN	like
"	``	"
brady	JJ	<unknown>
bunch	NN	bunch
"	''	"
robert	NN	<unknown>
reed	NN	reed
wants	VBZ	want
shakespeare	VB	<unknown>
himself	PP	himself
bb	RB	<unknown>
were	VBD	be
n't	RB	n't
industry	NN	industry
names	NNS	name
but	CC	but
were	VBD	be
n't	RB	n't
exactly	RB	exactly
starving	VBG	starve
either	RB	either
while	IN	while
got	VBN	get
history	NN	history
right	NN	right
poster	NN	poster
released	VBD	release
farrah	NN	<unknown>
got	VBD	get
silverman	NN	<unknown>
rejecting	VBG	reject
pitches	NNS	pitch
"	``	"
funniest	JJS	funny
home	NN	home
videos	NNS	video
"	''	"
"	``	"
american	JJ	American
idol	NN	idol
"	''	"
spelling	VBG	spell
promising	JJ	promising
baby	NN	baby
girl	NN	girl
tori	NNS	torus
someday	RB	someday
he	PP	he
'll	MD	will
create	VB	create
obviously	RB	obviously
did	VBD	do
not	RB	not
happen	VB	happen
bothered	VBN	bother
spelling	NN	spelling
's	POS	's
role	NN	role
distorted	VBD	distort
he	PP	he
's	VBZ	be
shown	VBN	show
as	IN	as
runner	NN	runner
creator	NN	creator
neither	CC	neither
"	``	"
comes	VBZ	come
up	RP	up
"	''	"
"	``	"
idea	NN	idea
"	''	"
ca	MD	ca
laughable	JJ	laughable
spelling	NN	spelling
goldberg	NN	<unknown>
allowed	VBD	allow
enforce	VB	enforce
farrah	NP	Farrah
's	POS	's
oral	JJ	oral
contract	NN	contract
signed	VBN	sign
did	VBD	do
n't	RB	n't
farrah	NN	<unknown>
bernstein	NN	<unknown>
tell	VBP	tell
leaving	VBG	leave
not	RB	not
discovered	VBN	discover
inner	JJ	inner
diva	NN	diva
but	CC	but
majors	NNS	major
wanted	VBD	want
tries	NNS	try
tries	NNS	try
created	VBD	create
conflict	NN	conflict
tension	NN	tension
setting	VBG	set
farrah	NN	<unknown>
up	RP	up
as	IN	as
"	``	"
bad	JJ	bad
girl	NN	girl
"	''	"
like	IN	like
suzanne	NN	<unknown>
somers	NNS	<unknown>
fails	VBZ	fail
groundwork	NN	groundwork
never	RB	never
laid	VBN	lay
"	''	"
three	CD	three
's	POS	's
company	NN	company
"	``	"
pic	JJ	<unknown>
delivered	VBN	deliver
