the	DT	the
reason	NN	reason
intended	VBD	intend
chance	NN	chance
2	CD	2
hours	NNS	hour
life	NN	life
actually	RB	actually
35	CD	@card@
minutes	NNS	minute
wish	VBP	wish
try	VB	try
understand	VBP	understand
hopefully	RB	hopefully
appreciate	VB	appreciate
indian	JJ	Indian
cinema	NN	cinema
all	DT	all
seen	VBN	see
few	JJ	few
older	JJR	old
s	NN	S
ray	NN	ray
browsing	NN	browsing
imdb	NN	<unknown>
came	VBD	come
seeing	VBG	see
rating	NN	rating
8	CD	8
7	CD	7
concluded	VBN	conclude
open	JJ	open
doors	NNS	door
unknown	NN	unknown
bring	VBP	bring
artistic	JJ	artistic
enjoyment	NN	enjoyment
oh	UH	oh
wrong	JJ	wrong
logical	JJ	logical
explanation	NN	explanation
rating	NN	rating
8	CD	8
7	CD	7
most	JJS	most
970	CD	@card@
people	NNS	people
voted	VBD	vote
indian	JJ	Indian
venture	NN	venture
outside	IN	outside
bolliwood	NN	<unknown>
production	NN	production
adam	NN	<unknown>
sandler	NN	<unknown>
rating	NN	rating
ranked	VBD	rank
9th	JJ	9th
place	NN	place
imdb	NN	<unknown>
list	NN	list
250	CD	@card@
best	JJS	good
citizen	NN	citizen
cane	NN	cane
goodfellas	NNS	<unknown>
psycho	JJ	psycho
really	RB	really
not	RB	not
mood	NN	mood
review	NN	review
criticize	VBP	criticize
simply	RB	simply
nothing	NN	nothing
worth	NN	worth
remembering	VBG	remember
painful	JJ	painful
experience	NN	experience
hope	NN	hope
lot	NN	lot
hindu	NN	Hindu
like	IN	like
as	IN	as
plain	JJ	plain
stupid	JJ	stupid
abundance	NN	abundance
kitsch	NN	kitsch
cheesy	JJ	cheesy
music	NN	music
