saw	NN	saw
'	POS	'
film	NN	film
'	''	'
recently	RB	recently
say	VBP	say
worst	JJS	bad
attempt	NN	attempt
film	NN	film
making	VBG	make
misfortune	NN	misfortune
hell	NN	hell
going	VBG	go
coolio	NN	<unknown>
totally	RB	totally
unprovoked	JJ	unprovoked
shooting	NN	shooting
people	NNS	people
distress	VBP	distress
totally	RB	totally
uninvolving	JJ	<unknown>
slow	JJ	slow
tedious	JJ	tedious
detached	JJ	detached
worse	RBR	worse
than	IN	than
spawn	VB	spawn
long	RB	long
live	JJ	live
"	''	"
evil	JJ	evil
dead	JJ	dead
ii	NN	<unknown>
"	''	"
