i	NNS	i
'm	VBP	be
big	JJ	big
fan	NN	fan
true	JJ	true
crime	NN	crime
genre	NN	genre
but	CC	but
could	MD	could
n't	RB	n't
sit	VB	sit
putrid	JJ	putrid
piece	NN	piece
almost	RB	almost
as	IN	as
dahmer	NN	<unknown>
intended	VBN	intend
as	IN	as
erotica	NN	erotica
porn	NN	porn
flic	JJ	<unknown>
soundtrack	NN	soundtrack
no	DT	no
look	NN	look
dahmer	NN	<unknown>
tick	VB	tick
no	DT	no
exploration	NN	exploration
victims	NNS	victim
nothing	NN	nothing
but	CC	but
"	``	"
look	VB	look
creepy	JJ	creepy
guy	NN	guy
"	''	"
filmmakers	NNS	filmmaker
much	JJ	much
dahmer	NN	<unknown>
creepiest	JJS	creepy
thing	NN	thing
disgrace	NN	disgrace
screen	NN	screen
