another	DT	another
long	JJ	long
line	NN	line
flicks	NNS	flick
people	NNS	people
think	VBP	think
knowing	VBG	know
operate	VB	operate
camera	NN	camera
as	IN	as
telling	VBG	tell
story	NN	story
15	CD	@card@
minutes	NNS	minute
entire	JJ	entire
premise	NN	premise
laid	VBD	lay
just	RB	just
few	JJ	few
lines	NNS	line
absolutely	RB	absolutely
no	DT	no
mystery	NN	mystery
eliminates	VBZ	eliminate
whole	JJ	whole
facet	NN	facet
suspense	NN	suspense
half	NN	half
way	NN	way
competent	JJ	competent
actor	NN	actor
killed	VBD	kill
10	CD	@card@
minutes	NNS	minute
film	VBP	film
we	PP	we
're	VBP	be
left	VBN	leave
stupid	JJ	stupid
characters	NNS	character
running	VBG	run
doing	VBG	do
stupid	JJ	stupid
things	NNS	thing
low	JJ	low
budget	NN	budget
films	NNS	film
ca	MD	ca
n't	RB	n't
afford	VB	afford
expensive	JJ	expensive
special	JJ	special
effects	NNS	effect
cgi	NN	<unknown>
portions	NNS	portion
unsurprisingly	RB	unsurprisingly
unimpressive	JJ	unimpressive
but	CC	but
least	RBS	least
valid	JJ	valid
attempt	NN	attempt
creature	NN	creature
suit	NN	suit
terrible	JJ	terrible
as	IN	as
seen	VBN	see
falls	VBZ	fall
sidewalk	NN	sidewalk
director	NN	director
keeps	VBZ	keep
emphasizing	VBG	emphasize
eyes	NNS	eye
are	VBP	be
n't	RB	n't
red	JJ	red
color	NN	color
shown	VBN	show
mirror	NN	mirror
shots	NNS	shot
dialogue	VBP	dialogue
clumsy	JJ	clumsy
uninspired	JJ	uninspired
lines	NNS	line
reminiscent	JJ	reminiscent
aliens	NNS	alien
terminator	NN	terminator
action	NN	action
sequence	NN	sequence
takes	VBZ	take
place	NN	place
police	NN	police
station	NN	station
rip	NN	rip
terminator	NN	terminator
hiding	NN	hiding
glass	NN	glass
lined	VBD	line
office	NN	office
darkwolf	NN	<unknown>
does	VBZ	do
n't	RB	n't
smash	VB	smash
end	NN	end
girl	NN	girl
calls	VBZ	call
hero	NN	hero
"	``	"
a	DT	a
good	JJ	good
protector	NN	protector
"	''	"
but	CC	but
gets	VBZ	get
partners	NNS	partner
original	JJ	original
protector	NN	protector
least	JJS	least
civilians	NNS	civilian
not	RB	not
mention	VBP	mention
dozen	NN	dozen
cops	VBZ	cop
all	DT	all
killed	VBN	kill
getting	VBG	get
decent	JJ	decent
shot	NN	shot
spite	NN	spite
arsenal	NN	arsenal
silver	NN	silver
bullets	NNS	bullet
submachine	JJ	submachine
gun	NN	gun
but	CC	but
here	RB	here
's	VBZ	be
real	JJ	real
clincher	NN	clincher
bad	JJ	bad
writing	NN	writing
killed	VBD	kill
beast	NN	beast
right	RB	right
beginning	VBG	begin
credits	NNS	credit
holding	VBG	hold
stripper	NN	stripper
while	IN	while
flashing	VBG	flash
red	JJ	red
eyes	NNS	eye
instead	RB	instead
took	VBD	take
custody	NN	custody
