this	DT	this
way	NN	way
hyped	VBD	hyp
lot	NN	lot
viewers	NNS	viewer
thought	VBD	think
"	``	"
amazing	JJ	amazing
"	''	"
old	JJ	old
school	NN	school
cause	NN	cause
whole	NN	whole
set	VBD	set
past	JJ	past
thought	NN	thought
just	RB	just
showing	VBG	show
past	IN	past
expecting	VBG	expect
faded	VBN	fade
dreamy	JJ	dreamy
like	IN	like
lighting	VBG	light
characters	NNS	character
pass	VB	pass
but	CC	but
just	RB	just
going	VBG	go
basically	RB	basically
trying	VBG	try
mix	NN	mix
future	NN	future
past	JJ	past
2	CD	2
do	VBP	do
n't	RB	n't
mix	VB	mix
very	RB	very
well	RB	well
special	JJ	special
effects	NNS	effect
actually	RB	actually
blue	JJ	blue
screen	NN	screen
actors	NNS	actor
working	VBG	work
too	RB	too
many	JJ	many
exactly	RB	exactly
did	VBD	do
no	DT	no
reason	NN	reason
critics	NNS	critic
hype	NN	hype
up	IN	up
saying	VBG	say
"	``	"
it	PP	it
's	VBZ	be
greatest	JJS	great
done	VBN	do
"	``	"
it	PP	it
's	VBZ	be
just	RB	just
crap	NN	crap
stick	NN	stick
did	VBD	do
n't	RB	n't
help	VB	help
story	NN	story
line	NN	line
sooo	NP	sooo
crappy	NN	<unknown>
do	VBP	do
n't	RB	n't
understand	VB	understand
hollywood	NN	<unknown>
agreed	VBD	agree
produced	VBN	produce
do	VBP	do
n't	RB	n't
understand	VB	understand
actors	NNS	actor
actresses	NNS	actress
willing	JJ	willing
like	IN	like
it	PP	it
's	VBZ	be
almost	RB	almost
as	RB	as
though	IN	though
everybody	NN	everybody
read	NN	read
script	NN	script
forgot	VBD	forget
read	VB	read
fine	JJ	fine
print	NN	print
"	''	"
it	PP	it
all	DT	all
computer	NN	computer
"	``	"
network	NN	network
nothing	NN	nothing
revolutionary	JJ	revolutionary
i	NNS	i
'm	VBP	be
very	RB	very
upset	VBN	upset
myself	PP	myself
paying	JJ	paying
money	NN	money
do	VBP	do
n't	RB	n't
waste	VB	waste
time	NN	time
money	NN	money
today	NN	today
tomorrow	NN	tomorrow
