otherwise	RB	otherwise
worst	JJS	bad
i	NNS	i
've	VBP	have
seen	VBN	see
mean	JJ	mean
wife	NN	wife
bored	VBD	bore
minds	NNS	mind
10	CD	@card@
minutes	NNS	minute
not	RB	not
mention	VBP	mention
boring	VBG	bore
entirely	RB	entirely
unbelievable	JJ	unbelievable
women	NNS	woman
non	JJ	non
lesbian	NN	lesbian
do	VBP	do
n't	RB	n't
bathe	VB	bathe
nor	CC	nor
"	``	"
accidentally	RB	accidentally
"	''	"
kiss	NN	kiss
brothers	NNS	brother
sisters	NNS	sister
do	VBP	do
n't	RB	n't
live	VB	live
well	RB	well
30s	CD	30s
run	NN	run
swing	NN	swing
dancing	VBG	dance
engaging	JJ	engaging
footraces	NNS	footrace
central	JJ	central
park	NN	park
men	NNS	man
do	VBP	do
n't	RB	n't
wife	NN	wife
sister	NN	sister
romantically	RB	romantically
kissed	VBD	kiss
night	NN	night
wedding	NN	wedding
never	RB	never
discuss	VB	discuss
said	VBN	say
wife	NN	wife
absolutely	RB	absolutely
ridiculous	JJ	ridiculous
heather	JJ	heather
graham	NN	graham
possibly	RB	possibly
worst	JJS	bad
actress	NN	actress
films	NNS	film
today	NN	today
smiles	VBZ	smile
crying	VBG	cry
vice	JJ	vice
versa	RB	versa
good	JJ	good
boogie	VBP	boogie
nights	NNS	night
was	VBD	be
n't	RB	n't
acting	JJ	acting
cannot	MD	can
stress	VB	stress
enough	RB	enough
bad	JJ	bad
