Steven	NP	Steven
Seagal	NP	<unknown>
appears	VBZ	appear
to	TO	to
be	VB	be
sleepwalking	VBG	sleepwalk
through	IN	through
a	DT	a
dreadful	JJ	dreadful
movie	NN	movie
shot	VBD	shoot
almost	RB	almost
entirely	RB	entirely
in	IN	in
close	VB	close
up	RP	up
to	TO	to
disguise	VB	disguise
the	DT	the
complete	JJ	complete
lack	NN	lack
of	IN	of
budget	NN	budget
and	CC	and
resources	NNS	resource
To	TO	To
pick	VB	pick
on	IN	on
the	DT	the
technical	JJ	technical
flaws	NNS	flaw
silver	JJ	silver
F	NP	F
A	NP	A
18s	NP	<unknown>
and	CC	and
F	NP	F
14s	NP	<unknown>
take	VB	take
of	IN	of
from	IN	from
a	DT	a
carrier	NN	carrier
for	IN	for
an	DT	an
air	NN	air
strike	NN	strike
and	CC	and
miraculously	RB	miraculously
become	VB	become
camouflaged	VBN	camouflage
F	NN	F
16s	JJ	<unknown>
for	IN	for
the	DT	the
actual	JJ	actual
strike	NN	strike
would	MD	would
give	VB	give
this	DT	this
movie	NN	movie
more	JJR	more
credibility	NN	credibility
than	IN	than
it	PP	it
deserves	VBZ	deserve
Suffice	VB	suffice
it	PP	it
to	TO	to
say	VB	say
that	IN	that
the	DT	the
most	RBS	most
interesting	JJ	interesting
thing	NN	thing
in	IN	in
the	DT	the
movie	NN	movie
is	VBZ	be
the	DT	the
credit	NN	credit
titles	NNS	title
which	WDT	which
fade	VBP	fade
on	IN	on
and	CC	and
then	RB	then
disappear	VB	disappear
in	IN	in
a	DT	a
lightning	NN	lightning
wipe	NN	wipe
which	WDT	which
presumably	RB	presumably
is	VBZ	be
available	JJ	available
to	TO	to
all	DT	all
users	NNS	user
of	IN	of
Final	NP	Final
Cut	NP	Cut
Pro	NP	Pro
Putting	VBG	put
all	PDT	all
your	PP$	your
creativity	NN	creativity
into	IN	into
your	PP$	your
own	JJ	own
credit	NN	credit
puts	VBZ	put
Michael	NP	Michael
Keusch	NP	<unknown>
in	IN	in
the	DT	the
same	JJ	same
category	NN	category
as	IN	as
Marcel	NP	Marcel
Mandu	NP	<unknown>
