"	''	"
Burning	VBG	burn
Paradise	NP	Paradise
"	``	"
is	VBZ	be
a	DT	a
combination	NN	combination
of	IN	of
neo	NP	<unknown>
Shaw	NP	Shaw
Brothers	NPS	Brothers
action	NN	action
and	CC	and
Ringo	NP	Ringo
Lam	NP	Lam
's	POS	's
urban	JJ	urban
cynicism	NN	cynicism
When	WRB	when
one	PP	one
watches	VBZ	watch
the	DT	the
film	NN	film
they	PP	they
might	MD	might
feel	VB	feel
the	DT	the
fight	NN	fight
scenes	NNS	scene
are	VBP	be
only	RB	only
mediocre	JJ	mediocre
in	IN	in
nature	NN	nature
but	CC	but
that	WDT	that
does	VBZ	do
n't	RB	n't
matter	VB	matter
it	PP	it
's	POS	's
attitude	NN	attitude
and	CC	and
atmosphere	NN	atmosphere
that	WDT	that
counts	VBZ	count
This	DT	this
great	JJ	great
film	NN	film
has	VBZ	have
both	DT	both
Always	RB	always
trying	VBG	try
to	TO	to
be	VB	be
different	JJ	different
than	IN	than
his	PP$	his
contemporaries	NNS	contemporary
Lam	NP	Lam
gives	VBZ	give
us	PP	us
to	TO	to
traditional	JJ	traditional
heroes	NNS	hero
Fong	NP	Fong
Sai	NP	Sai
Yuk	NP	Yuk
and	CC	and
Hung	NP	Hung
Shi	NP	Shi
Kwan	NP	Kwan
and	CC	and
puts	VBZ	put
them	PP	them
in	IN	in
a	DT	a
"	``	"
Raiders	NP	<unknown>
of	IN	of
the	DT	the
Lost	NP	<unknown>
Ark	NP	Ark
"	''	"
setting	VBG	set
However	RB	however
these	DT	these
are	VBP	be
not	RB	not
the	DT	the
light	NN	light
hearted	VBD	heart
comedic	JJ	comedic
incarnations	NNS	incarnation
that	IN	that
you	PP	you
might	MD	might
see	VB	see
in	IN	in
a	DT	a
Jet	NP	Jet
Li	NP	Li
movie	NN	movie
Instead	RB	instead
these	DT	these
guys	NNS	guy
fight	NN	fight
to	TO	to
the	DT	the
death	NN	death
with	IN	with
brutal	JJ	brutal
results	NNS	result
What	WP	What
makes	VBZ	make
the	DT	the
film	NN	film
even	RB	even
better	RBR	well
is	VBZ	be
that	IN	that
anyone	NN	anyone
could	MD	could
die	VB	die
at	IN	at
anytime	RB	anytime
there	EX	there
is	VBZ	be
no	DT	no
holding	NN	holding
back	RB	back
Too	RB	too
bad	JJ	bad
they	PP	they
do	VBP	do
n't	RB	n't
make	VB	make
films	NNS	film
like	IN	like
this	DT	this
more	RBR	more
often	RB	often
