This	DT	this
typical	JJ	typical
Mamet	NN	Mamet
film	NN	film
delivers	VBZ	deliver
a	DT	a
quiet	NN	quiet
evenly	RB	evenly
paced	VBN	pace
insight	NN	insight
into	IN	into
what	WP	what
makes	VBZ	make
a	DT	a
confidence	NN	confidence
man	NN	man
Joe	NP	Joe
Mantegna	NP	Mantegna
good	JJ	good
Explored	NN	<unknown>
as	IN	as
a	DT	a
psychological	JJ	psychological
study	NN	study
by	IN	by
a	DT	a
noted	JJ	noted
psychologist	NN	psychologist
Lindsay	NP	Lindsay
Crouse	NP	Crouse
it	PP	it
slowly	RB	slowly
pulls	VBZ	pull
her	PP	her
into	IN	into
his	PP$	his
world	NN	world
with	IN	with
the	DT	the
usual	JJ	usual
nasty	JJ	nasty
consequences	NNS	consequence
The	DT	the
cast	NN	cast
includes	VBZ	include
a	DT	a
number	NN	number
of	IN	of
the	DT	the
players	NNS	player
found	VBN	find
is	VBZ	be
several	JJ	several
of	IN	of
Mamet	NP	Mamet
's	POS	's
films	NNS	film
Steven	NP	Steven
Goldstein	NP	Goldstein
Jack	NP	Jack
Wallace	NP	Wallace
Ricky	NP	Ricky
Jay	NP	Jay
Andy	NP	Andy
Potok	NP	<unknown>
Allen	NP	Allen
Soule	NP	Soule
William	NP	William
H	NP	H
Macy	NP	Macy
and	CC	and
they	PP	they
do	VBP	do
their	PP$	their
usual	JJ	usual
good	JJ	good
job	NN	job
I	PP	I
loved	VBD	love
Lindsay	NP	Lindsay
Crouse	NP	Crouse
in	IN	in
this	DT	this
film	NN	film
and	CC	and
have	VBP	have
often	RB	often
wondered	VBN	wonder
why	WRB	why
she	PP	she
did	VBD	do
n't	RB	n't
become	VB	become
a	DT	a
more	RBR	more
noted	JJ	noted
player	NN	player
than	IN	than
she	PP	she
has	VBZ	have
become	VBN	become
Perhaps	RB	perhaps
I	PP	I
'm	VBP	be
not	RB	not
looking	VBG	look
in	IN	in
the	DT	the
right	NN	right
places	VBZ	place
The	DT	the
movie	NN	movie
proceeds	NNS	proceed
at	IN	at
a	DT	a
slow	JJ	slow
pace	NN	pace
with	IN	with
flat	JJ	flat
dialog	NN	dialog
yet	CC	yet
it	PP	it
maintains	VBZ	maintain
a	DT	a
level	NN	level
of	IN	of
tension	NN	tension
throughout	IN	throughout
which	WDT	which
logically	RB	logically
leads	VBZ	lead
to	TO	to
the	DT	the
bang	NN	bang
up	IN	up
ending	VBG	end
You	PP	you
'd	MD	will
expect	VB	expect
a	DT	a
real	JJ	real
let	NN	let
down	RB	down
at	IN	at
the	DT	the
ending	VBG	end
but	CC	but
I	PP	I
found	VBD	find
it	PP	it
uplifting	VBG	uplift
and	CC	and
satisfying	VBG	satisfy
I	PP	I
love	VBP	love
this	DT	this
movie	NN	movie
