I	PP	I
was	VBD	be
in	IN	in
a	DT	a
bad	JJ	bad
frame	NN	frame
of	IN	of
mind	NN	mind
when	WRB	when
I	PP	I
first	RB	first
saw	VBD	see
this	DT	this
movie	NN	movie
For	IN	for
some	DT	some
reason	NN	reason
it	PP	it
clicked	VBD	click
on	IN	on
all	PDT	all
my	PP$	my
levels	NNS	level
tensions	NNS	tension
in	IN	in
a	DT	a
family	NN	family
loneliness	NN	loneliness
and	CC	and
the	DT	the
want	VBP	want
of	IN	of
someone	NN	someone
to	TO	to
share	VB	share
your	PP$	your
life	NN	life
with	IN	with
It	PP	it
did	VBD	do
n't	RB	n't
hurt	VB	hurt
that	IN	that
the	DT	the
someone	NN	someone
to	TO	to
share	VB	share
your	PP$	your
life	NN	life
with	IN	with
was	VBD	be
such	PDT	such
a	DT	a
beautiful	JJ	beautiful
girl	NN	girl
as	IN	as
Claire	NP	Claire
Cyndy	NP	Cyndy
Preston	NP	Preston
I	PP	I
also	RB	also
bought	VBD	buy
the	DT	the
sound	JJ	sound
track	NN	track
to	TO	to
this	DT	this
movie	NN	movie
very	RB	very
hard	JJ	hard
to	TO	to
get	VB	get
Loved	JJ	<unknown>
it	PP	it
and	CC	and
hope	VBP	hope
it	PP	it
will	MD	will
someday	RB	someday
come	VB	come
out	RP	out
on	IN	on
DV	NP	DV
