A	DT	a
sweet	JJ	sweet
natured	JJ	natured
young	JJ	young
mountain	NN	mountain
man	NN	man
with	IN	with
a	DT	a
sad	JJ	sad
past	JJ	past
Henry	NP	Henry
Thomas	NP	Thomas
comes	VBZ	come
upon	IN	upon
an	DT	an
abandoned	VBN	abandon
baby	NN	baby
girl	NN	girl
in	IN	in
the	DT	the
woods	NNS	wood
and	CC	and
instantly	RB	instantly
falls	VBZ	fall
in	IN	in
love	NN	love
with	IN	with
her	PP	her
The	DT	the
town	NN	town
elders	NNS	elder
generally	RB	generally
support	VBP	support
him	PP	him
in	IN	in
keeping	VBG	keep
the	DT	the
child	NN	child
though	IN	though
a	DT	a
local	JJ	local
temptress	NN	temptress
Cara	NP	Cara
Seymour	NP	Seymour
thinks	VBZ	think
little	RB	little
of	IN	of
the	DT	the
new	JJ	new
family	NN	family
A	DT	a
determined	VBN	determine
little	JJ	little
girl	NN	girl
on	IN	on
a	DT	a
long	JJ	long
walk	NN	walk
and	CC	and
a	DT	a
sinister	JJ	sinister
travelling	VBG	travel
salesman	NN	salesman
David	NP	David
Strathairn	NP	<unknown>
at	IN	at
his	PP$	his
creepiest	JJS	creepy
have	VBP	have
parallel	JJ	parallel
stories	NNS	storey
which	WDT	which
converge	VBP	converge
in	IN	in
a	DT	a
fateful	JJ	fateful
way	NN	way
This	DT	this
is	VBZ	be
a	DT	a
charming	JJ	charming
slice	NN	slice
of	IN	of
life	NN	life
in	IN	in
the	DT	the
Ozarks	NPS	Ozarks
in	IN	in
the	DT	the
same	JJ	same
vein	NN	vein
as	IN	as
"	``	"
Where	WRB	where
The	DT	the
Lillies	NP	<unknown>
Bloom	NP	Bloom
"	''	"
"	''	"
The	DT	the
Dollmaker	NP	<unknown>
"	``	"
All	DT	all
three	CD	three
were	VBD	be
shot	VBN	shoot
on	IN	on
location	NN	location
in	IN	in
those	DT	those
beautiful	JJ	beautiful
hills	NNS	hill
and	CC	and
cover	VB	cover
the	DT	the
lives	NNS	life
of	IN	of
simple	JJ	simple
living	NN	living
but	CC	but
not	RB	not
simple	JJ	simple
minded	JJ	minded
American	JJ	American
folk	NN	folk
A	DT	a
minimum	NN	minimum
of	IN	of
strong	JJ	strong
language	NN	language
and	CC	and
brief	JJ	brief
but	CC	but
pointed	JJ	pointed
violence	NN	violence
make	VB	make
this	DT	this
fairly	RB	fairly
safe	JJ	safe
family	NN	family
viewing	NN	viewing
