I	PP	I
live	VBP	live
in	IN	in
Missouri	NP	Missouri
so	IN	so
the	DT	the
direct	JJ	direct
effects	NNS	effect
of	IN	of
terrorism	NN	terrorism
are	VBP	be
largely	RB	largely
unknown	JJ	unknown
to	TO	to
me	PP	me
this	DT	this
brought	VBD	bring
it	PP	it
home	RB	home
That	DT	that
two	CD	two
men	NNS	man
would	MD	would
put	VB	put
themselves	PP	themselves
on	IN	on
the	DT	the
line	NN	line
in	IN	in
the	DT	the
way	NN	way
that	IN	that
those	DT	those
members	NNS	member
of	IN	of
FDNY	NP	<unknown>
and	CC	and
NYPD	NP	<unknown>
did	VBD	do
just	RB	just
to	TO	to
document	VB	document
the	DT	the
horror	NN	horror
that	WDT	that
unfolded	VBD	unfold
on	IN	on
that	DT	that
day	NN	day
This	DT	this
film	NN	film
is	VBZ	be
a	DT	a
testament	NN	testament
to	TO	to
those	DT	those
who	WP	who
lost	VBD	lose
their	PP$	their
lives	NNS	life
and	CC	and
the	DT	the
true	JJ	true
evil	NN	evil
that	IN	that
terror	NN	terror
brings	VBZ	bring
