I	PP	I
miss	VBP	miss
Dark	NP	Dark
Angel	NP	Angel
I	PP	I
understand	VBP	understand
not	RB	not
ever	RB	ever
one	PP	one
likes	VBZ	like
it	PP	it
but	CC	but
as	RB	as
far	RB	far
as	IN	as
I	PP	I
'm	VBP	be
concerned	VBN	concern
the	DT	the
show	NN	show
should	MD	should
not	RB	not
have	VB	have
been	VBN	be
canceled	VBN	cancel
especially	RB	especially
for	IN	for
another	DT	another
space	NN	space
show	NN	show
mock	JJ	mock
up	IN	up
I	PP	I
'm	VBP	be
reading	VBG	read
the	DT	the
books	NNS	book
now	RB	now
they	PP	they
are	VBP	be
doing	VBG	do
a	DT	a
pretty	RB	pretty
good	JJ	good
job	NN	job
of	IN	of
explaining	VBG	explain
somethings	NNS	<unknown>
but	CC	but
I	PP	I
still	RB	still
think	VBP	think
we	PP	we
should	MD	should
get	VB	get
a	DT	a
TV	NN	TV
movie	NN	movie
or	CC	or
something	NN	something
THE	DT	the
FREAK	NN	freak
NATION	NP	Nation
LIVES	NP	Lives
