Very	RB	very
nicely	RB	nicely
done	VBN	do
movie	NN	movie
It	PP	it
does	VBZ	do
stay	VB	stay
in	IN	in
your	PP$	your
memory	NN	memory
Better	NN	better
billed	VBN	bill
as	IN	as
a	DT	a
romance	NN	romance
than	IN	than
flying	VBG	fly
or	CC	or
war	NN	war
altho	NN	<unknown>
the	DT	the
flying	VBG	fly
parts	NNS	part
are	VBP	be
realistic	JJ	realistic
and	CC	and
almost	RB	almost
error	NN	error
free	JJ	free
Flying	NP	Flying
buffs	NNS	buff
like	VBP	like
myself	PP	myself
will	MD	will
enjoy	VB	enjoy
this	DT	this
movie	NN	movie
even	RB	even
if	IN	if
attracted	VBN	attract
by	IN	by
the	DT	the
airplanes	NNS	airplane
unless	IN	unless
they	PP	they
have	VBP	have
no	DT	no
sensitivity	NN	sensitivity
or	CC	or
have	VBP	have
never	RB	never
been	VBN	be
in	IN	in
love	NN	love
Fun	NP	<unknown>
watching	VBG	watch
early	JJ	early
Crowe	NP	Crowe
He	PP	he
is	VBZ	be
good	JJ	good
and	CC	and
exudes	VBZ	exude
charm	VB	charm
His	PP$	his
reading	NN	reading
of	IN	of
"	``	"
High	NP	High
Flight	NP	Flight
"	''	"
is	VBZ	be
superb	JJ	superb
cheers	VBZ	cheer
Boom	NP	Boom
