Christopher	NP	Christopher
Lee	NP	Lee
is	VBZ	be
one	CD	one
of	IN	of
my	PP$	my
favorite	JJ	favorite
actors	NNS	actor
I	PP	I
'm	VBP	be
trying	VBG	try
to	TO	to
view	VB	view
all	DT	all
of	IN	of
his	PP$	his
work	NN	work
He	PP	he
has	VBZ	have
been	VBN	be
known	VBN	know
to	TO	to
single	VB	single
handedly	RB	<unknown>
save	VB	save
movies	NNS	movie
with	IN	with
his	PP$	his
presence	NN	presence
Unfortunately	RB	unfortunately
this	DT	this
is	VBZ	be
not	RB	not
one	CD	one
of	IN	of
them	PP	them
This	DT	this
movie	NN	movie
suffers	VBZ	suffer
from	IN	from
a	DT	a
low	JJ	low
budget	NN	budget
and	CC	and
it	PP	it
's	POS	's
production	NN	production
values	NNS	value
are	VBP	be
disturbing	VBG	disturb
Please	RB	please
for	IN	for
the	DT	the
love	NN	love
of	IN	of
Christopher	NP	Christopher
avoid	VB	avoid
this	DT	this
film	NN	film
