I	PP	I
had	VBD	have
some	DT	some
reservations	NNS	reservation
about	IN	about
this	DT	this
movie	NN	movie
I	PP	I
figured	VBD	figure
it	PP	it
would	MD	would
be	VB	be
the	DT	the
usual	JJ	usual
bill	NN	bill
of	IN	of
fare	NN	fare
a	DT	a
formula	NN	formula
movie	NN	movie
about	IN	about
Christmas	NP	Christmas
Being	VBG	be
in	IN	in
the	DT	the
middle	NN	middle
of	IN	of
a	DT	a
heat	NN	heat
wave	NN	wave
in	IN	in
late	JJ	late
June	NP	June
we	PP	we
decided	VBD	decide
to	TO	to
give	VB	give
it	PP	it
a	DT	a
shot	NN	shot
anyway	RB	anyway
maybe	RB	maybe
we	PP	we
would	MD	would
see	VB	see
some	DT	some
snow	NN	snow
This	DT	this
movie	NN	movie
turned	VBD	turn
out	RP	out
to	TO	to
be	VB	be
one	CD	one
laugh	NN	laugh
after	IN	after
another	DT	another
Ben	NP	Ben
Affleck	NP	Affleck
was	VBD	be
believable	JJ	believable
in	IN	in
his	PP$	his
character	NN	character
but	CC	but
the	DT	the
real	JJ	real
star	NN	star
of	IN	of
this	DT	this
one	CD	one
is	VBZ	be
James	NP	James
Gandofini	NP	<unknown>
He	PP	he
delivered	VBD	deliver
his	PP$	his
lines	NNS	line
with	IN	with
a	DT	a
real	JJ	real
wit	NN	wit
about	IN	about
him	PP	him
and	CC	and
made	VBD	make
a	DT	a
great	JJ	great
"	``	"
dad	NN	dad
"	''	"
If	IN	if
you	PP	you
want	VBP	want
to	TO	to
have	VB	have
an	DT	an
enjoyable	JJ	enjoyable
couple	NN	couple
of	IN	of
hours	NNS	hour
definitely	RB	definitely
check	VBP	check
this	DT	this
one	CD	one
out	IN	out
