This	DT	this
piece	NN	piece
ai	VBZ	ai
n't	RB	n't
really	RB	really
worth	JJ	worth
a	DT	a
comment	NN	comment
It	PP	it
's	VBZ	be
simply	RB	simply
the	DT	the
worst	JJS	bad
"	``	"
horror	NN	horror
"	''	"
movie	NN	movie
i	NNS	i
have	VBP	have
ever	RB	ever
seen	VBN	see
The	DT	the
actors	NNS	actor
are	VBP	be
bad	JJ	bad
as	IN	as
bad	JJ	bad
can	MD	can
be	VB	be
and	CC	and
the	DT	the
whole	JJ	whole
plot	NN	plot
is	VBZ	be
so	RB	so
silly	JJ	silly
it	PP	it
nearly	RB	nearly
made	VBD	make
me	PP	me
cry	VBP	cry
Shame	NN	shame
on	IN	on
you	PP	you
I	PP	I
say	VBP	say
