Dire	JJ	dire
Just	RB	just
dire	JJ	dire
The	DT	the
script	NN	script
is	VBZ	be
contrived	VBN	contrive
the	DT	the
acting	VBG	act
painful	JJ	painful
and	CC	and
the	DT	the
story	NN	story
just	RB	just
drags	VBZ	drag
along	IN	along
It	PP	it
is	VBZ	be
without	IN	without
a	DT	a
doubt	NN	doubt
a	DT	a
celebration	NN	celebration
of	IN	of
Sally	NP	Sally
Potter	NP	Potter
and	CC	and
little	RB	little
else	RB	else
This	DT	this
would	MD	would
n't	RB	n't
be	VB	be
so	RB	so
bad	JJ	bad
but	CC	but
she	PP	she
's	VBZ	be
the	DT	the
director	NN	director
writer	NN	writer
and	CC	and
star	NN	star
of	IN	of
the	DT	the
film	NN	film
and	CC	and
so	RB	so
is	VBZ	be
just	RB	just
self	JJ	self
glorification	NN	glorification
I	PP	I
found	VBD	find
myself	PP	myself
not	RB	not
caring	JJ	caring
about	IN	about
the	DT	the
developing	VBG	develop
romance	NN	romance
between	IN	between
the	DT	the
principal	JJ	principal
two	CD	two
characters	NNS	character
and	CC	and
the	DT	the
ending	NN	ending
came	VBD	come
not	RB	not
a	DT	a
moment	NN	moment
too	RB	too
soon	RB	soon
It	PP	it
has	VBZ	have
two	CD	two
redeeming	JJ	redeeming
features	NNS	feature
First	RB	first
is	VBZ	be
that	IN	that
a	DT	a
lot	NN	lot
of	IN	of
the	DT	the
shots	NNS	shot
are	VBP	be
really	RB	really
quite	RB	quite
lovely	JJ	lovely
particularly	RB	particularly
in	IN	in
Paris	NP	Paris
and	CC	and
look	VB	look
rather	RB	rather
good	JJ	good
in	IN	in
black	JJ	black
and	CC	and
white	JJ	white
Secondly	RB	secondly
whether	IN	whether
you	PP	you
're	VBP	be
a	DT	a
fan	NN	fan
of	IN	of
tango	NN	tango
or	CC	or
not	RB	not
the	DT	the
music	NN	music
is	VBZ	be
by	IN	by
and	CC	and
large	JJ	large
excellent	JJ	excellent
except	IN	except
where	WRB	where
Sally	NP	Sally
starts	VBZ	start
singing	VBG	sing
Watch	NP	<unknown>
this	DT	this
film	NN	film
at	IN	at
your	PP$	your
own	JJ	own
risk	NN	risk
or	CC	or
if	IN	if
you	PP	you
need	VBP	need
an	DT	an
unintentional	JJ	unintentional
laugh	NN	laugh
I	PP	I
am	VBP	be
sure	JJ	sure
it	PP	it
appeals	VBZ	appeal
to	TO	to
someone	NN	someone
Statistically	RB	statistically
it	PP	it
has	VBZ	have
to	TO	to
