Excruciatingly	RB	excruciatingly
slow	RB	slow
paced	VBN	pace
over	IN	over
scripted	VBN	script
black	JJ	black
comedy	NN	comedy
with	IN	with
a	DT	a
too	RB	too
clever	JJ	clever
premise	NN	premise
and	CC	and
bad	JJ	bad
acting	VBG	act
Maybe	RB	maybe
this	DT	this
would	MD	would
have	VB	have
worked	VBN	work
as	IN	as
a	DT	a
Twilight	NP	<unknown>
Zone	NP	Zone
or	CC	or
Tales	NP	Tales
from	IN	from
the	DT	the
Crypt	JJ	<unknown>
episode	NN	episode
but	CC	but
by	IN	by
the	DT	the
last	JJ	last
half	NN	half
you	PP	you
just	RB	just
want	VBP	want
it	PP	it
to	TO	to
get	VB	get
to	TO	to
its	PP$	its
predictable	JJ	predictable
ending	NN	ending
and	CC	and
be	VB	be
done	VBN	do
with	IN	with
it	PP	it
already	RB	already
