This	DT	this
is	VBZ	be
arguably	RB	arguably
the	DT	the
worst	JJS	bad
film	NN	film
I	PP	I
have	VBP	have
ever	RB	ever
seen	VBN	see
and	CC	and
I	PP	I
have	VBP	have
quite	PDT	quite
an	DT	an
appetite	NN	appetite
for	IN	for
awful	JJ	awful
and	CC	and
good	JJ	good
movies	NNS	movie
It	PP	it
could	MD	could
just	RB	just
have	VB	have
managed	VBN	manage
a	DT	a
kind	NN	kind
of	IN	of
adolescent	JJ	adolescent
humour	NN	humour
if	IN	if
it	PP	it
had	VBD	have
been	VBN	be
consistently	RB	consistently
tongue	NN	tongue
in	IN	in
cheek	NN	cheek
la	NP	la
ROCKY	NP	Rocky
HORROR	NP	<unknown>
PICTURE	NP	Picture
SHOW	NP	Show
which	WDT	which
was	VBD	be
really	RB	really
very	RB	very
funny	JJ	funny
Other	JJ	other
movies	NNS	movie
like	IN	like
PLAN	NP	Plan
NINE	NP	Nine
FROM	NP	From
OUTER	NP	Outer
SPACE	NP	Space
manage	VBP	manage
to	TO	to
be	VB	be
funny	JJ	funny
while	IN	while
apparently	RB	apparently
trying	VBG	try
to	TO	to
be	VB	be
serious	JJ	serious
As	RB	as
to	TO	to
the	DT	the
acting	NN	acting
it	PP	it
looks	VBZ	look
like	IN	like
they	PP	they
rounded	VBD	round
up	RB	up
brain	VB	brain
dead	JJ	dead
teenagers	NNS	teenager
and	CC	and
asked	VBD	ask
them	PP	them
to	TO	to
ad	NN	ad
lib	NN	lib
the	DT	the
whole	JJ	whole
production	NN	production
Compared	VBN	compare
to	TO	to
them	PP	them
Tom	NP	Tom
Cruise	NP	Cruise
looks	VBZ	look
like	IN	like
Alec	NP	Alec
Guinness	NP	Guinness
There	RB	there
was	VBD	be
one	CD	one
decent	JJ	decent
interpretation	NN	interpretation
that	IN	that
of	IN	of
the	DT	the
older	JJR	old
ghoul	NN	ghoul
busting	VBG	bust
broad	JJ	broad
on	IN	on
the	DT	the
motorcycle	NN	motorcycle
