When	WRB	when
I	PP	I
first	RB	first
watched	VBD	watch
Robotboy	NP	<unknown>
I	PP	I
found	VBD	find
it	PP	it
fresh	JJ	fresh
and	CC	and
interesting	JJ	interesting
but	CC	but
then	RB	then
I	PP	I
noticed	VBD	notice
that	IN	that
with	IN	with
each	DT	each
episode	NN	episode
this	DT	this
show	NN	show
is	VBZ	be
trying	VBG	try
to	TO	to
teach	VB	teach
you	PP	you
how	WRB	how
to	TO	to
behave	VB	behave
yourself	PP	yourself
what	WP	what
is	VBZ	be
good	JJ	good
bad	JJ	bad
Episodes	NNS	episode
became	VBD	become
predictable	JJ	predictable
And	CC	and
main	JJ	main
characters	NNS	character
are	VBP	be
not	RB	not
interesting	JJ	interesting
Again	RB	again
we	PP	we
see	VBP	see
a	DT	a
hyper	NN	hyper
smart	JJ	smart
boy	NN	boy
beaten	VBN	beat
by	IN	by
his	PP$	his
older	JJR	old
brother	NN	brother
parents	NNS	parent
who	WP	who
do	VBP	do
n't	RB	n't
understand	VB	understand
their	PP$	their
kid	NN	kid
and	CC	and
his	PP$	his
friends	NNS	friend
girl	NN	girl
and	CC	and
fat	JJ	fat
boy	NN	boy
Also	RB	also
this	DT	this
show	NN	show
has	VBZ	have
no	DT	no
logic	NN	logic
A	DT	a
super	JJ	super
modern	JJ	modern
robot	NN	robot
who	WP	who
works	VBZ	work
on	IN	on
two	CD	two
AA	NP	<unknown>
size	NN	size
batteries	NNS	battery
and	CC	and
can	MD	can
use	VB	use
a	DT	a
lot	NN	lot
of	IN	of
weapons	NNS	weapon
But	CC	but
the	DT	the
biggest	JJS	big
problem	NN	problem
is	VBZ	be
the	DT	the
difference	NN	difference
between	IN	between
activated	VBN	activate
and	CC	and
super	JJ	super
activated	VBN	activate
modes	NNS	mode
We	PP	we
see	VBP	see
two	CD	two
different	JJ	different
robots	NNS	robot
and	CC	and
it	PP	it
declines	VBZ	decline
main	JJ	main
idea	NN	idea
of	IN	of
the	DT	the
show	NN	show
"	``	"
Robot	NP	<unknown>
must	MD	must
learn	VB	learn
how	WRB	how
to	TO	to
behave	VB	behave
himself	PP	himself
in	IN	in
human	JJ	human
society	NN	society
"	''	"
