Now	RB	now
I	PP	I
like	VBP	like
sci	NN	<unknown>
fi	NN	<unknown>
cartoons	NNS	cartoon
However	RB	however
when	WRB	when
"	``	"
Robotboy	NP	<unknown>
"	''	"
appeared	VBD	appear
in	IN	in
Canada	NP	Canada
in	IN	in
late	RB	late
2006	CD	@card@
I	PP	I
watched	VBD	watch
the	DT	the
premiere	NN	premiere
and	CC	and
was	VBD	be
inevitably	RB	inevitably
appalled	VBN	appall
The	DT	the
characters	NNS	character
are	VBP	be
generic	JJ	generic
and	CC	and
stereotypical	JJ	stereotypical
Do	VBP	do
they	PP	they
REALLY	RB	really
need	VBP	need
to	TO	to
make	VB	make
an	DT	an
African	JJ	African
American	JJ	American
man	NN	man
wear	NN	wear
tiger	NN	tiger
stripe	NN	stripe
print	NN	print
clothing	NN	clothing
and	CC	and
speak	VB	speak
in	IN	in
a	DT	a
Jamacian	JJ	<unknown>
accent	NN	accent
WHY	WRB	why
are	VBP	be
all	PDT	all
the	DT	the
Asian	JJ	Asian
characters	NNS	character
vibrant	JJ	vibrant
yellow	NN	yellow
and	CC	and
squinting	VBG	squint
Does	NP	Does
the	DT	the
mother	NN	mother
HAVE	NP	Have
to	TO	to
have	VB	have
big	JJ	big
thighs	NNS	thigh
and	CC	and
chest	NN	chest
and	CC	and
constantly	RB	constantly
complain	VB	complain
to	TO	to
the	DT	the
point	NN	point
where	WRB	where
things	NNS	thing
become	VBP	become
unrealistic	JJ	unrealistic
predictable	JJ	predictable
gross	JJ	gross
and	CC	and
sometimes	RB	sometimes
disturbing	VBG	disturb
There	EX	there
are	VBP	be
heavy	JJ	heavy
similarities	NNS	similarity
to	TO	to
even	VB	even
stabs	NNS	stab
at	IN	at
Astro	NP	Astro
Boy	NP	Boy
Allow	NP	<unknown>
me	PP	me
to	TO	to
explain	VB	explain
dub	NN	dub
names	NNS	name
for	IN	for
the	DT	the
young	JJ	young
Robotboy	NP	<unknown>
Astro	NP	Astro
Kamikaze	NP	<unknown>
Tenma	NP	<unknown>
Constantine	NP	Constantine
Shadow	NP	Shadow
Gus	NP	Gus
Abercrombie	NP	Abercrombie
Tommy	NP	Tommy
Alejo	NP	Alejo
Lola	NP	Lola
Zoran+Kennedy	NP	<unknown>
Moshimo	NP	<unknown>
O'Shay	NP	<unknown>
and	CC	and
it	PP	it
so	RB	so
on	IN	on
Brief	NN	brief
resemblances	NNS	resemblance
to	TO	to
"	``	"
My	NP	My
Life	NP	Life
As	IN	as
A	DT	a
Teenage	NP	<unknown>
Robot	NP	<unknown>
"	''	"
"	''	"
Star	NP	Star
Wars	NP	Wars
"	''	"
"	''	"
Teenage	NP	<unknown>
Mutant	NP	<unknown>
Ninja	NP	Ninja
Turtles	NPS	Turtles
"	''	"
"	''	"
Kamen	NP	Kamen
Riders	NP	<unknown>
"	''	"
"	''	"
Sailor	NP	Sailor
Moon	NP	Moon
"	''	"
and	CC	and
co	NP	Co
are	VBP	be
afoot	RB	afoot
Not	RB	not
to	TO	to
mention	VB	mention
the	DT	the
abundant	JJ	abundant
racial	JJ	racial
gender	NN	gender
stereotyping	VBG	stereotype
Do	NP	Do
n't	RB	n't
even	RB	even
get	VB	get
me	PP	me
started	VBN	start
on	IN	on
the	DT	the
innuendos	NNS	innuendo
I	PP	I
'll	MD	will
just	RB	just
say	VB	say
they	PP	they
're	VBP	be
hidden	VBN	hide
and	CC	and
quite	RB	quite
dirty	JJ	dirty
But	CC	but
seriously	RB	seriously
Do	VBP	do
n't	RB	n't
even	RB	even
try	VB	try
watching	VBG	watch
this	DT	this
Especially	RB	especially
if	IN	if
you	PP	you
like	IN	like
Astro	NP	Astro
Boy	NP	Boy
