This	DT	this
was	VBD	be
truly	RB	truly
dreadful	JJ	dreadful
It	PP	it
had	VBD	have
a	DT	a
terrible	JJ	terrible
storyline	NN	storyline
was	VBD	be
poorly	RB	poorly
acted	VBN	act
and	CC	and
was	VBD	be
like	IN	like
an	DT	an
amateur	JJ	amateur
remake	NN	remake
of	IN	of
evil	JJ	evil
dead	JJ	dead
but	CC	but
not	RB	not
nearly	RB	nearly
as	RB	as
good	JJ	good
It	PP	it
took	VBD	take
all	PDT	all
my	PP$	my
tenacity	NN	tenacity
to	TO	to
make	VB	make
it	PP	it
through	IN	through
this	DT	this
one	CD	one
it	PP	it
's	VBZ	be
a	DT	a
good	JJ	good
job	NN	job
I	PP	I
did	VBD	do
n't	RB	n't
have	VB	have
to	TO	to
visit	VB	visit
the	DT	the
toilet	NN	toilet
else	RB	else
I	PP	I
doubt	VBP	doubt
I	PP	I
would	MD	would
have	VB	have
come	VBN	come
back	RB	back
This	DT	this
one	CD	one
makes	VBZ	make
Hammer	NP	Hammer
House	NP	House
of	IN	of
Horror	NP	<unknown>
look	VBP	look
like	IN	like
a	DT	a
big	JJ	big
screen	NN	screen
Hollywood	NP	Hollywood
epic	NN	epic
The	DT	the
only	JJ	only
value	NN	value
to	TO	to
this	DT	this
movie	NN	movie
was	VBD	be
the	DT	the
never	RB	never
ending	VBG	end
supply	NN	supply
of	IN	of
beautiful	JJ	beautiful
women	NNS	woman
Not	RB	not
a	DT	a
bad	JJ	bad
one	CD	one
among	IN	among
them	PP	them
If	IN	if
you	PP	you
want	VBP	want
to	TO	to
letch	VB	letch
with	IN	with
your	PP$	your
friends	NNS	friend
after	IN	after
a	DT	a
night	NN	night
on	IN	on
the	DT	the
beer	NN	beer
then	RB	then
this	DT	this
one	CD	one
's	VBZ	be
for	IN	for
you	PP	you
else	RB	else
avoid	VB	avoid
it	PP	it
like	IN	like
the	DT	the
plague	NN	plague
